....ㅠㅠㅠㅠㅠ	sad
...ㅅㅂ	angry
..제발…ㅠ	sad
..ㅠㅠ	sad
.욕녀	angry
?	natural
??	natural
????ㅋㅋㅋ	excite
?ㅋㅋ	excite
?ㅠ	sad
^^	excite
~~~~~	excite
>_<	excite
>_<ㅋㅋ	excite
…..ㅠㅠㅠㅠㅠㅠ	sad
……..ㅠ	sad
…ㅠ	sad
♥	excite
07월 22일	natural
85너서그지	sad
T.T	sad
TT	sad
가가다	natural
가격대오다	natural
가끔까다	natural
가늘다	sad
가다	natural
가르다	natural
가슴살	natural
가슴아프다	sad
가시다	angry
가싶다	sad
가없다	sad
가위눌리다	angry
가져오다	excite
가지가다	excite
가지다	angry
가지잇다	natural
가출하다	natural
가치	natural
가ㅋ	excite
간병있다	natural
간지네	excite
갈가다	natural
갈다	excite
갈마시다	natural
감면감다	natural
감사감사!!ㅋㅋ	excite
감사하다	excite
감정없다	angry
갑네	natural
값못하다	sad
같다	natural
같다	sad
같이같다	sad
개개다	angry
개뉸	angry
개다	angry
개됐었네	sad
개망나니	angry
개같은새끼	angry
개년	angry
개새끼	angry
개새끼닥치다	angry
개시러	angry
개실망	angry
개없다	sad
개자자다	natural
개졸리	natural
개집	natural
개짜증	angry
개짱	angry
개쩔어ㅋㅋ	excite
개피곤	angry
개힘들다	angry
객관적보다	natural
거거다	natural
거기거다	natural
거기냐	natural
거꾸로솟다	angry
거다	natural
거부하다	sad
거싱숭생숭하다	sad
거알다	sad
거야거다	natural
거지거다	excite
거하게쏜다	excite
걱정돼죽겠네	sad
건들다	angry
건물폐쇄	sad
걸다	angry
걸리다	natural
검정	natural
겁나다	angry
겁나죠앙ㅋㅋ	excite
것없다	sad
게더없다	sad
게분명하다	angry
게아니다	sad
게알다	angry
게없다	natural
게이기다	excite
게차분해지다	sad
게참차다	excite
겟음	sad
겨기다	sad
결혼하다	natural
계속쪄	angry
고고고다	natural
고기고다	excite
고다	excite
고동색	natural
고르다	angry
고맙다	natural
고생시다	sad
고싶어ㅠㅠ	sad
고잇어	natural
고프다	natural
곤욕하지만하다	sad
공방외롭다	sad
공부하다	natural
과외해줘	natural
과자먹어ㅋㅋ	excite
과자이르다	natural
관리하다	excite
관심알다	angry
관심없다	angry
괜찮다	sad
괴롭히다	angry
교회시러	angry
구	excite
구분못하다	angry
구원하다	excite
국	angry
국먹는구	natural
국모닝	excite
국물닭발이지?	excite
국민연금?	natural
굿	excite
굿밤	excite
굿밤칭구들♥	excite
귀엽다	excite
그거얻어먹다	angry
그거재밌겠네	excite
그게맞다	excite
그까다	angry
그냥생각하다	sad
그따위살지다	angry
그때좋다	sad
그래고맙다	natural
그래관리못하다	sad
그래그래!!!ㅋㅋ	excite
그래랍	excite
그래미치다	angry
그래사다	angry
그래서결국울다	sad
그래서안다	angry
그러그르다	sad
그러사기업가다	angry
그런게더이상하다	sad
그런관계아니다	sad
그런나이나다	sad
그런만말다	angry
그럴거	natural
그럼나줘ㅋㅋ	excite
그렇게그렇다	sad
그리고그리다	natural
그립다	sad
그만그울울다	sad
그만그좀조다	angry
그만그하자하다	angry
그만그해하다	angry
그만나나다	angry
그정도죽다	excite
그졸조다	angry
그째지다	excite
금없다	natural
기다	natural
기다리다	natural
기대다	excite
기대하다	excite
기되다	excite
기둘기둘ㅋㅋ	excite
기미박혀	sad
기분안좋다	sad
기억하다	natural
기운없다	sad
기중	natural
긴장되다	sad
김기다	excite
김밥쏘다	excite
까다	sad
까ㅜㅜ	sad
깔다	excite
깜찍하다	excite
깝쳐	angry
깨쏟아지다	excite
깨지다	natural
꺼지다	angry
꼬	natural
꼬다	excite
꼬락서니하다	angry
꼬이다	natural
꼭보다	natural
꼭욕하다	angry
꼭지터지다	angry
꼴않다	angry
꽉막혔어	angry
꿈꾸다	angry
끄다	angry
끝내다	angry
끼리끼다	angry
ㄳㅋㅋㅋㅋㅋ	excite
ㄴㄴ괜찮	sad
나가다	natural
나게좀하지마	angry
나기하다	sad
나꿈앗아가다	sad
나나다	angry
나대다	angry
나도나다	natural
나두..	natural
나라미치다	angry
나라지키다	natural
나물뜯다	excite
나버림?	sad
나보다	natural
나부	natural
나서다	angry
나예민	angry
나오늘제사	natural
나오다	natural
나우울	sad
나이나다	natural
나이스	excite
나좀이해해줘라	sad
나즐거워	excite
나출발하다	natural
나키다	angry
나턱살쪄서불편	angry
나한테왜이래유우우	sad
나허리아파ㅜ	sad
난니생각	excite
난분식집옆	natural
난쌈닭	angry
날나다	natural
날낫다	angry
날다	sad
날리다	angry
날씨좋다	excite
남같지않다	sad
남나다	angry
남다	natural
남아남다	natural
낫다	natural
내가가서깨울꺼	angry
내기?	natural
내나쁘다	sad
내내다	sad
내다	sad
내리다	natural
내만나다	angry
내시좋다	sad
내지말구.	sad
내치다	excite
낼내다	natural
냄새쩔어	angry
냐	excite
너거거다	natural
너내알다	natural
너무걱정하다	sad
너무멀다	sad
너무변하다	sad
너무슬퍼슬프다	sad
너무아프다	angry
너무어리다	natural
너무크다	angry
너무해하다	sad
너무힘들다	sad
너소개주다	natural
너수익내다	excite
너안하다	angry
너있다	natural
너잘자다	natural
너잠못다	sad
너죽다	angry
넌냄새낭	angry
넌널다	excite
넘다	excite
네게갈다	excite
네깨지다	natural
넵>_<	excite
넷!!	excite
녀왔니	excite
노래노랗다	natural
노래방	natural
노래불러	natural
놀다	excite
놀러가다	excite
놓다	angry
놔두다	angry
누다	natural
눈낮추다	natural
눈물머금다	sad
눈치빠르다	excite
느끼다	sad
느낌느끼다	excite
늘다	natural
늙다	sad
늦게갈꺼면콜	natural
늦다	angry
니사정	angry
니있다	sad
님돼	natural
다	excite
다들화팅!!	excite
다르다	excite
다른다르다	natural
다리올리다	excite
다무스네	natural
다묵어쩌???ㅠㅠㅠ	sad
다스	angry
다시봄보다	excite
다오다	natural
다쳤어?!ㅠ	sad
닥쵸	angry
닥치다	angry
달래다	excite
달리다	natural
달콤하다	natural
닭발먹고힘내장~	excite
답답하다	angry
답없다	sad
당근ㅋㅋㅋㅋㅋ	excite
당연히먹었지ㅋㅋ	excite
당황하다	natural
당ㅠ!	sad
대견하다	excite
대답하다	angry
대박!	excite
대박ㅋㅋ	excite
대하다	natural
댕기다	sad
더늘다	sad
더불쌍	sad
더해하다	sad
던지다	excite
덜깻	angry
데다	angry
데뷔시켜주삼ㅋㅋ	excite
데뷔하다	excite
도라지?유자?	natural
도와주다	sad
돈다잃음	sad
돈다털렸어	sad
돈벌다	natural
돈좋다	excite
돈주움	excite
돈지랄쟁	sad
돋다	excite
돌들다	angry
돌아오다	sad
돌았구	angry
돌았냐	angry
돌았네	angry
동료분	natural
돼먹다	sad
돼지년	angry
돼지머리맞다	natural
되거다	sad
되다	excite
되데다	natural
두!	excite
두개	natural
두고보다	angry
두곧ㅋㅋ	excite
두다	natural
두루두우만	natural
뒤지다	angry
드리다	sad
듣기싫어	angry
듣다	angry
들	angry
들다	sad
들리다	excite
들어가다	angry
듯	natural
듯하다	natural
디	natural
디스크있다	sad
디지것다ㅋㅋ	natural
따써먹어	angry
땅묶이다	natural
땡스	excite
땡큐땡큐!!!	excite
떄려치자	angry
떡해ㅠ	sad
떨거지	sad
또	angry
띄어쓰기없다	natural
띠박	angry
띵호아	excite
라	natural
라븅	excite
란.	angry
랑	excite
래	natural
래틀어놓다	excite
러버~~	excite
러지ㅠ	sad
럴까…	sad
렇게	sad
레토	natural
렛미노	natural
로마?	natural
리세상살기힘드냐	sad
마	sad
마시다	natural
마음대안되다	sad
마진콜아저씨	natural
만나다	natural
만말다	sad
만알다	natural
많다	sad
말나나다	angry
말다	angry
말말다	sad
말못하다	sad
말알다	angry
말없다	angry
말이사가다	excite
말좋다	natural
말하다	sad
맘알다	angry
맛나다	natural
맛싶어싶다	sad
맛없다	excite
맛잇겟다	excite
맛있다	excite
망하다	angry
맞다	angry
맡기다	natural
매매다	angry
매정하다	sad
매친	angry
매콤하다	sad
매틴ㅋㅋㅋㅋㅋㅋㅋ	excite
맥주먹어	excite
머러~ㅜㅜ	sad
머리깨지다	sad
머플러어울리다	natural
먹거파	excite
먹지말	natural
먼저	natural
멀다	sad
멀쩡하다	angry
멋쓰다	natural
멋지다	excite
메다	excite
면사끄다	excite
명심하다	natural
모르다	sad
모욕햇어	angry
모의사다	angry
목관통	sad
몰다	natural
몰라주다	sad
몸좀봐>_<	excite
못가겠다…ㅜ	sad
못먹어	sad
못믿다	angry
못보다	sad
못쓰다	natural
못참겠어..눈물	sad
못하겟오ㅜㅜㅡ	sad
못하다	sad
몽롱하다	excite
무리하다	natural
무변하다	sad
무서워ㅠ	sad
무시하다	angry
무지방우유	natural
무하지하다	natural
묵념하다	natural
문자씹다	angry
물렸당.	sad
뭉클하다	sad
뭐냐	natural
뭐래	natural
뭐있다	natural
뭐저래	angry
뭐지	natural
뭐하다	angry
뭐해?	natural
미	angry
미끄러지다	sad
미미하다	natural
미안.	sad
미안하다	sad
미안해용서해줘	sad
미워	sad
미쳐버리겠다	angry
미치다	angry
믿다	excite
밀려썼어	angry
밀어주다	natural
ㅂㅅ	angry
바달려가다	excite
바쁘다	natural
바쁭가	natural
반반하다	natural
반전	natural
반하다	excite
받다	excite
발리	natural
발목서주면대지	natural
밤샘안되다	sad
밥맛나다	excite
밥맛없다	sad
방울나다	sad
배너무아파	angry
배당주다	natural
배아파죽겠넹	sad
배아프다	sad
배파하다	sad
백병원	sad
버려버려	natural
버리다	sad
번주	natural
벌다	excite
베베다	excite
벼리다	angry
변하다	angry
별	natural
별거없다	natural
병신	angry
병신놈설치다	angry
병줄이다	natural
보고보다	excite
보기조아^^	excite
보내삼!!	excite
보다	angry
보다	sad
보라보다	natural
보라색	natural
보러따오다	sad
보사기사다	excite
보있다	excite
보장	excite
보힘내다	angry
복잡하다	sad
볼보다	excite
봄보다	excite
봐.	sad
부끄	excite
부러워서씨바앙ㅋㅋ	excite
부르다	excite
부어서지금.	sad
부진계시다	sad
부탁드리다	natural
분데다	natural
분명	natural
불쌍해죽겠어…	sad
뷰	excite
븅딱ㅋㅋㅋ	excite
브레이크다	natural
비다	excite
비많이온당ㅠㅠ	sad
비얼마안다	excite
비참해서.	sad
빈털털이	sad
빙고!	excite
빠큐	angry
빡쳐	angry
빨간색	natural
빼다	excite
빼빼다	sad
빽사줘	excite
뽀흐하하하하하하	excite
뿅^^	excite
ㅄ	angry
ㅅㅂ	angry
ㅅㅂ것	angry
ㅅㅂㄴㅁ	angry
ㅅㅂ년	angry
ㅅㅂ놈	angry
사고뻔하다	angry
사고사다	natural
사다	natural
사란말씀?	natural
사람사다	angry
사람없다	sad
사랑스러워죽겠넹	excite
사랑하다	excite
사룽	excite
사말다	angry
사사다	sad
사싶다	sad
사주다	natural
사진	natural
사진사다	excite
살다	natural
살보다	angry
살아있다	excite
살있다	excite
삼사다	sad
삼진삼다	natural
상세히설명좀	natural
상쾌하다	excite
새끼	angry
새새다	sad
생각하다	natural
생강차	natural
생기다	sad
생리하다	angry
생일하다	natural
생축하하다	excite
서그래	natural
서럽다	sad
서뭐	sad
서서다	angry
서울?	natural
선사하다	excite
선택한길나나다	sad
성격나오다	angry
성공하다	excite
성품보다	natural
세다	sad
세상!!	sad
섹시하다	excite
션	natural
소개팅	excite
소개하다	excite
소고기사다	excite
소다	excite
소리소다	excite
소비재괜찮다	natural
소식없다	sad
소용	sad
속보이다	sad
속상하다	sad
속쓰리다	sad
손입다	sad
쇼핑가다	excite
쇼핑중~	excite
수고하다	excite
수없다	sad
수잇다	natural
수있다	natural
수하다	natural
순수하다	natural
술먹고싶다	angry
술먹까다	sad
술안먹엉~	natural
술처먹고	angry
숨쉬다	sad
쉣	angry
쉬다	excite
쉬발랄라네	angry
쉬하다	angry
스물셋	natural
스타하쟤	natural
스트레스풀다	excite
스티커붙	natural
슬럼픈가봐	sad
슬프다	sad
승뺏겼어…	sad
시끄러ㅡㅡ	angry
시댕	angry
시름	angry
시미치다	angry
시비걸다	angry
시뻘개졌어	angry
시원해이제	excite
시작하다	excite
시집가래가다	sad
시험싸다	angry
신나다	excite
신나다	excite
신호대기중	natural
신혼바쁘다	natural
싫다	angry
심술좀부려보깡	excite
심심하다	natural
싱냥댱	excite
싱숭생숭하다	sad
싶다	natural
싶어싶다	sad
싸다	angry
싸댭	angry
싸우다	angry
싸움싸우다	natural
싸움안되다	excite
쌍놈	angry
쌔다	excite
써먹다	angry
써서열	angry
쎄?	natural
쏴ㅋㅋㅋㅋㅋㅋ	excite
쒯이양	angry
쓰늘다	natural
쓰레기	angry
쓰쓰다	angry
쓸남자	sad
씁쓸하다	sad
씨댕	angry
씨발닥쳐	angry
씨발련	angry
씨부랄	angry
씨팔	angry
씹돼지	angry
씻다	natural
ㅇㅇㅋㅋㅋㅋㅋㅋㅋㅋ	excite
ㅇㅋ	natural
ㅇㅋㅇㅋ~~	excite
아.....어디냐.	sad
아..개망.	sad
아..야구또졌어ㅜㅜㅜ	sad
아..힘	sad
아같다	natural
아귀찮다	angry
아그렇다	natural
아깝다	sad
아꿉당ㅠㅠㅠ	sad
아놔ㅅㅂ	angry
아놔진짜	angry
아늘다	excite
아니	natural
아니다	natural
아드리다	excite
아또살쪘어ㅠ	sad
아못하겟다구ㅜㅜㅜ	sad
아무것도하기싫다	sad
아무렴..	natural
아배아파	angry
아버님..ㄷㄷㄷ	natural
아소화안돼ㅠ	sad
아쉬매려	angry
아쉽다	sad
아시아	natural
아싸뵹	excite
아쓰벌ㅠ	angry
아이쁘다	excite
아저씨	natural
아저씨하다	natural
아존나웃기당	excite
아지갑잃어버렸어	sad
아지다	angry
아직	natural
아짱	angry
아침날나다	angry
아침들어가다	natural
아파	sad
아파?	sad
아하하하하하하하하하	excite
아홉걸깨닫다	natural
아ㅠㅠㅠ	sad
악몽꿨어	angry
안건거야거다	excite
안내하다	excite
안녕하다	natural
안다	sad
안되다	sad
안물어봐	angry
안받다	natural
안알다	sad
안올라	sad
안와오다	angry
안타깝다	sad
안하냠	natural
안하다	sad
않다	natural
알다	excite
알모르다	sad
알봐주다	natural
알수없다	sad
알아보다	natural
앗뇽ㅋ	excite
앗다	natural
애기들♥	excite
애기영화	natural
야	natural
야근	sad
야들	natural
야지	natural
야ㅡㅡ	angry
약속생기다	natural
약속하다	excite
얌	excite
얏호~	excite
얘기좀해줘..답답해ㅜ	sad
얘기하다	natural
얘들	natural
어딘지	natural
어딜	natural
어때?	natural
어떡하다	sad
어떻다	sad
어려보	excite
어머머	angry
어봤다	sad
어예~~	excite
어울리다	excite
어이없다	angry
어지럽다	sad
어쩌어쩌다	angry
어쩜져앙>-<	excite
억지토하다	angry
얻어먹다	natural
얼다	excite
얼마안반못하다	sad
엄청매운맛먹고시픈데ㅡㅡ	angry
엄하다	natural
없다	sad
없다.	sad
었는데	natural
엉엉	sad
에디에다	natural
에모이다	natural
에에다	natural
에잇알다	angry
에헤다	excite
여자친구생기다	excite
여지껏놀	excite
역겹다	angry
역세권	excite
역시..	sad
연구실	natural
연기금사다	natural
연기금하다	natural
연락없다	angry
연애안	natural
연애하다	excite
영하다	excite
영화보다	natural
영화보러가다	excite
예리하다	natural
예민하다	angry
예전밝아지다	sad
옘병	angry
오~	sad
오겠지.	sad
오늘너무바뿌당..ㅜ	sad
오늘배꼽잡고웃었다	excite
오늘있다	excite
오다	natural
오붓하오붓하다	excite
오삼오삼!!ㅋㅋ	excite
오이오다	natural
오잇다	angry
오잉???	sad
오지마ㅛ	angry
오지않다	angry
오케이하다	natural
오킹	natural
오호	excite
오호!	excite
올건지안올건지딱말	angry
올것	angry
올오다	excite
올하다	natural
올해	natural
옷많	excite
와오다	angry
와오다	excite
완전무서워ㅠㅠㅠ	sad
완전부러워ㅠ	sad
완전시러	angry
완전잘생기다	excite
왕짜증	angry
왜그랬을까.	sad
왜먹어디런것	angry
왜외다	angry
왜욕해너	angry
왜이러지	sad
외다	natural
외롭다	sad
외롭다진다지다	sad
외박업슴	natural
외톨	sad
요^^	natural
욕나오다	angry
욕맥이지말어	angry
욕하다	angry
우리신다	natural
우리친하다	sad
우선	natural
우수워?	angry
우숩냐?	angry
우엑	angry
우오~뽕빼고온나!!	excite
우울하다	sad
우ㅏ쟈기>_<	excite
운동가되다	angry
운동하다	natural
운전하다	angry
울다	sad
울소다	excite
울울다	sad
울컥	sad
웃기다	excite
웃기웃다	excite
웃기있다	angry
웅!!!굿밤다들!!!>_<	excite
웅>_<	excite
워	angry
월급ㅋㅋㅋㅋㅋㅋ	excite
월요일데다	natural
웡	excite
위기오다	sad
위독하셧네	sad
유감	sad
유유우우우우우ㅜㅜㅜㅜㅜㅜㅜㅜㅜㅜㅜㅜㅜ	sad
유치하다	natural
유학가다	natural
유행어	excite
윤택하다	excite
으…………	sad
으아………….ㅠㅠㅠㅠㅠㅠㅠㅠㅠㅠㅠ	sad
으하하하	excite
음그렇다	natural
응고다	natural
응답바람	natural
응얘기하다	natural
읭?	natural
이	excite
이걸먹어줘야	natural
이군!	excite
이기다	angry
이년..	angry
이따밤갈다	sad
이래?	angry
이래살다	sad
이런넘다	angry
이럴때기회ㅋ	natural
이렇게많어	angry
이르다	sad
이쁘다	excite
이사가다	natural
이상하다	natural
이제	natural
이죽다	excite
이틀내세우다	natural
이해안되다	sad
이해하다	angry
이히히	excite
인원자르다	sad
인제	angry
인증샷	excite
인증ㅋㅋㅋㅋ	excite
일단물어보다	natural
일때려치다	sad
일부러그런게아니다	sad
일없다	angry
일일이보고하다	angry
일찍오다	natural
일찍일어나다	angry
일찍헤어지다	sad
일하다	natural
읽다	angry
입고입다	angry
입다	angry
입다물다	angry
입맛없다	sad
잇다	angry
잇으	angry
잇힝	excite
있다	sad
있당	excite
잉ㅠ,ㅠ	sad
ㅈㅅ	excite
자꺼??	natural
자꾸그르다	sad
자꾸안되다	sad
자다	natural
자리터지다	excite
자유롭다	excite
자유없다	sad
자자다	excite
잔소리좀하지마	angry
잘다	natural
잘데다	excite
잘못말함	natural
잘못하다	sad
잘자다	excite
잘하다	sad
잠깨다	natural
잠시보다	natural
잡다	angry
잣!!	excite
잣다	sad
장난치다	angry
장사안댄	angry
장사하다	excite
장없다	sad
장하다	excite
재미땅	excite
재미없다	angry
재미있다	excite
재미지	excite
재밌지	excite
재수없다	angry
재주있다	angry
재추진	natural
쟈기바빠?	sad
저거하다	natural
저음?	natural
저질	angry
저찍잘다	sad
저하다	natural
적응안되다	sad
전략벌쓰다	natural
전문점	natural
전절다	natural
전화하다	natural
젊다	natural
점같다	natural
정늘다	natural
정떨어지다	angry
정신차리다	angry
정책있다	natural
정하다	sad
제거지	sad
제못하다	natural
제바쁘다	natural
젠장	angry
젤맛있다	natural
져	angry
져아져아	excite
조개먹냐	natural
조기조다	natural
조사	natural
조선잉가	natural
조심하다	sad
존나높	angry
졸다	angry
졸조다	natural
좀다풀고	natural
좀조다	sad
좃	sad
종목없다	angry
좆tothe망	angry
좆같다	angry
좆박았냐	angry
좆생기다	angry
좋겟네	sad
좋다	excite
주다	sad
주둥이다물다	angry
주둥이닥치다	angry
주둥이없애버리다	angry
주먹고싶다	natural
주식시장좃다	sad
주제	angry
주제모르다	angry
주제파악하다	angry
주차장되다	angry
죽다	sad
죽싶다	angry
줄다	natural
줄자다	sad
줄주다	excite
즐겁다	excite
지.	sad
지갑잃어버리다	angry
지금보니까	natural
지금필요하다	natural
지나다	excite
지다	sad
지던지다	angry
지랄	angry
지랄하다	angry
지르다	excite
지모르겠어.	sad
지모ㅎㅎㅎㅎ	excite
지뭐	sad
지올라가다	angry
지워버려	angry
지침지치다	angry
지키다	angry
지하데다	natural
직아프다	angry
직열다	angry
진짜	angry
진짜웃기다	excite
진짜ㅋㅋ	excite
질지다	natural
짐싸다	natural
짐지다	natural
집도착	excite
집중하다	natural
짜증까다	angry
짜증살찌다	angry
짠하다	sad
짱	excite
쩌네	angry
쩌러ㅋㅋㅋㅋㅋㅋㅋㅋㅋㅋㅋㅋㅋㅋ	excite
쩐다	angry
쩔겠네	excite
쩔어쩔어	excite
쩔지	excite
쪼	excite
쭉쭉빠지다	sad
쮸발	angry
ㅊㅋㅊㅋ	excite
차다	excite
차라리게낫다	excite
차라리굶다	angry
차라리무기만들다	excite
차못다	sad
차별하다	natural
차존나많네	angry
차차다	angry
착하당	excite
찬성세세다	excite
참다	sad
참보다	sad
참하다	natural
채양배추	natural
처막혔냐	angry
처음어렵다	excite
천재네ㅋㅋㅋ	excite
청량시키다	natural
쳇.!!!!	angry
최고	natural
최선가요가다	natural
추카추카	excite
추하다	angry
축구졸못	angry
축하전해전하다	excite
축하하다	excite
출발안하다	angry
충전하다	natural
치싶다	angry
치킨치키다	excite
칠치다	natural
ㅋ	natural
ㅋㅋ	natural
ㅋㅋ겁나웃겨ㅋㅋ	excite
ㅋㅋㅋ	excite
ㅋㅋㅋ겁나땡기지?ㅋ	excite
ㅋㅋㅋ그치!ㅋㅋ	excite
ㅋㅋㅋ미안허	sad
ㅋㅋㅋ미치겠다	excite
ㅋㅋㅋ즐거웠지	excite
ㅋㅋㅋㅋ	excite
ㅋㅋㅋㅋ개집ㅋㅋㅋㅋ	excite
ㅋㅋㅋㅋ웃교	excite
ㅋㅋㅋㅋㅋ	excite
ㅋㅋㅋㅋㅋ개놈ㅋㅋㅋㅋ	excite
ㅋㅋㅋㅋㅋ대바악	excite
ㅋㅋㅋㅋㅋㅋ	excite
ㅋㅋㅋㅋㅋㅋ븅딱	excite
ㅋㅋㅋㅋㅋㅋㅋ	excite
ㅋㅋㅋㅋㅋㅋㅋ알ㅋㅋㅋㅋ시밬ㅋㅋㅋㅋㅋ	excite
ㅋㅋㅋㅋㅋㅋㅋㅋ	excite
ㅋㅋㅋㅋㅋㅋㅋㅋ대박	excite
ㅋㅋㅋㅋㅋㅋㅋㅋㅋ굿밤	excite
ㅋㅋㅋㅋㅋㅋㅋㅋㅋㅋㅋㅋㅋㅋㅋㅋㅋㅋㅋ	excite
캡슐사하다	natural
커..?	natural
코스테	natural
콜!!!!!!!!!!!	excite
콜?	excite
쿄쿄켜켜	excite
키되다	natural
키짱커	excite
키커?ㅋㅋㅋ	excite
키키키	excite
ㅌㅋㅋㅋ	excite
타다	angry
탈출하다	excite
탔엉ㅠㅠㅠㅠㅠㅠ	sad
터지다	excite
터키윤거	natural
테까다	natural
토마토시다	angry
토온오다	sad
토와오다	angry
토하다	angry
통가다	natural
통하다	angry
퇴근못했엉?ㅜㅜ	sad
투척	natural
틀리다	natural
티내다	angry
팅기지망ㅋㅋ	excite
파죽겠네	sad
파트주다	excite
파파다	sad
편육맛나겄다!	natural
편하다	sad
평가하다	natural
평생	natural
푸히히	excite
푹낼아프다	sad
풀다	angry
풍월읊다	excite
플수	sad
피곤피다	sad
피곤하다	angry
피다	excite
필피다	excite
ㅎㅎㅎㅎㅎ	excite
ㅎㅎㅎㅎㅎㅎ	excite
하나하다	natural
하다	natural
하락	sad
하말다	excite
하싶다	natural
하자하다	natural
하잖오	natural
하지만하다	sad
하지말	angry
하하다	excite
한강가자가다	excite
한국어주다	natural
한대하다	natural
한잔	excite
한테물어보다	angry
한테쓰다	angry
한테있다	sad
한하다	natural
할머니돌아가다	sad
할하다	angry
핡	excite
함하다	angry
항상더추하다	natural
해도하다	angry
해서하다	angry
해장중ㅋㅋㅋ	excite
해죽기보직전지다	sad
해하다	natural
해ㅜㅜ힘들겟어아주	sad
행복하다	excite
행사많다	sad
허락맡	natural
허전하다	sad
헐	sad
헐…왜?ㅜㅜ	sad
헐다	excite
험악하다	natural
헤다	excite
헤어지쟤	sad
헬기던지다	natural
혀	sad
호해져배아풍	sad
혼자기다	sad
화나다	angry
화풀어미안	sad
확정	sad
환장하다	angry
홧팅	excite
후회되다	sad
후회많다	natural
훈이까다	natural
휴	sad
휴지있다	natural
흑흑	sad
흔들다	excite
흔하다	natural
흠	sad
흠..	sad
흥미알다	natural
희망갖다	excite
희소식있다	natural
히하다	natural
히히히히히♥	excite
힘내다	sad
힘들겟지	sad
힘들다	sad
힘없다	sad
ㅗ	angry
ㅗㅗ	angry
ㅗㅗㅗ	angry
ㅜ	sad
ㅜ.ㅜ	sad
ㅜ_ㅜ	sad
ㅜㅜ	sad
ㅜ-ㅜ	sad
ㅜㅜㅜㅜㅜㅜ	sad
ㅜㅜㅜㅜㅜㅜㅜㅜ	sad
ㅜㅡㅜ	sad
ㅠ	sad
ㅠ.ㅠ	sad
ㅠ_ㅠ	sad
ㅠㅁㅠ	sad
ㅠㅠ	sad
ㅠ-ㅠ	sad
ㅠㅠㅠ	sad
ㅠㅠㅠㅜㅠ	angry
ㅠㅠㅠㅠ	sad
ㅠㅠㅠㅠㅠㅠㅠㅠㅠㅠ	sad
ㅠㅡㅠ	sad
ㅡㅡ	angry
ㅡㅡㅋ	excite
가만두다	natural
가방	natural
가엾다	sad
가져가다	natural
가족	natural
가찮다	angry
감동적인	excite
감동하다	excite
감미로운	excite
감사	excite
감사염	excite
강아지	natural
갚다	natural
개뇬	angry
개똥	angry
개새낑	angry
개색기	angry
개색히	angry
개소리	angry
개솔	angry
거리감	sad
거슬리다	angry
거절	sad
거지	sad
걱정	sad
걱정되다	sad
건들다	angry
겁나	angry
겁나다	sad
게임	excite
겜	excite
격노하다	angry
격분하다	angry
결제하다	natural
결혼	excite
결혼식	excite
고고씽	excite
고깝다	angry
고뇌스럽다	sad
고단하다	sad
고독하다	sad
고립되다	sad
고민되다	sad
고민하다	sad
고생하다	sad
고양이	natural
고장나다	angry
고통	sad
고통스럽다	sad
공격	angry
공짜	excite
공허하다	sad
과연	natural
과제	angry
관심	excite
광고	angry
괘씸하다	angry
괜찮다	natural
괴롭다	sad
괴팍하다	angry
구슬프다	sad
굿나잇	excite
굿모닝	excite
굿밤	excite
권태롭다	sad
귀찮다	angry
그냥	natural
그따구	angry
그래	natural
그럼	natural
그렇다	natural
그려	natural
근심되다	sad
금지하다	natural
긍정	excite
기다리다	natural
기대하다	excite
기력나다	excite
기분상하다	angry
기분좋다	excite
기쁘다	excite
기억나다	natural
기운나다	excite
기운없다	sad
긴장되다	sad
까다	angry
까먹다	angry
까불다	angry
까임	angry
까지	natural
깜깜하다	sad
깨지다	angry
꺄	excite
꺄아	excite
꼬집다	angry
꼴깝	angry
꼴사납다	angry
꽁돈	excite
꽁짜	excite
꾸리꾸리	sad
꿀꿀하다	sad
끌리다	excite
낄낄	excite
나가다	natural
나두	natural
나르다	natural
나쁘다	sad
나오다	natural
나이스	excite
나이트	excite
나중에	natural
낙담하다	sad
낙심	sad
낙천	excite
난쟁이	angry
날카롭다	angry
남자친구	natural
남친	natural
낭만	excite
낭패	angry
내리다	natural
내일	natural
낼	natural
냄새나다	angry
냉랭하다	angry
냉정하다	angry
넘어지다	angry
넣다	natural
네	natural
넵	natural
넹	natural
노래방	excite
노발대발	angry
노안	angry
노하다	angry
녹다	natural
녹음하다	natural
놀고있네	angry
놀고파	excite
놀다	excite
놀아줘	excite
놀자	excite
놓다	natural
놓치다	angry
눈깔	angry
눈물	sad
눈물나다	sad
늙다	angry
늦잠	angry
니미	angry
다이어트	angry
다정하다	excite
다치다	sad
닥달하다	sad
닥쳐	angry
달다	natural
담배	natural
답답하다	sad
당당하다	excite
당혹스럽다	angry
대가리	angry
대박	excite
대인기피	sad
더럽다	angry
덕후	angry
덥다	angry
데이트	excite
도취	excite
돌아가다	natural
돌아가시다	sad
돌아다니다	natural
돌았냐	angry
동생	natural
동안	excite
동영상	natural
동정하다	sad
돼지	angry
두렵다	sad
뒤틀리다	angry
듣다	natural
들뜨다	excite
들어오다	natural
따뜻하다	excite
따분하다	sad
딱하다	sad
땀	angry
땡볕	angry
땡큐	excite
떄리다	angry
떡짐	angry
떨리다	sad
떫다	angry
또라이	angry
똑같다	natural
러뷰	excite
럽럽	excite
루저	angry
링겔	sad
마시다	natural
마우스	natural
마음아프다	sad
마음에들다	excite
마치다	natural
막막하다	sad
만끽하다	excite
만나다	natural
만남	excite
만족스럽다	excite
만지다	natural
많다	natural
말다	natural
말하다	natural
말해주다	natural
맑다	excite
맛있다	excite
맛집	excite
망하다	angry
맞짱	angry
맞추다	natural
매력	excite
매력있다	excite
매료되다	excite
매스껍다	angry
매친	angry
매혹	excite
맥빠지다	sad
맺혀지다	sad
머싯다	excite
머저리	angry
머해	natural
먹다	natural
멋있다	excite
멋지다	excite
멍청하다	angry
멍하다	sad
멜랑꼴리	sad
멸시	angry
명랑하다	excite
모르다	natural
모욕	angry
목표달성	excite
몸매	excite
못나다	angry
못마땅	angry
못생기다	angry
못하다	natural
몽롱하다	sad
무감각	sad
무겁다	sad
무관심	angry
무기력	sad
무뇌	angry
무섭다	sad
무슨	natural
무시당하다	sad
무시하다	angry
무신경	angry
무심하다	sad
무아지경	excite
물어보다	natural
뭉클하다	sad
뭐하다	natural
뭔죄	angry
미안하다	sad
미어지다	sad
미용실	excite
미치다	angry
미투	excite
민감하다	sad
민망하다	sad
밀다	natural
바르다	natural
바쁘다	natural
바이러스	angry
반갑다	excite
반하다	excite
반함	excite
받다	natural
받아오다	natural
발랄하다	excite
밝다	excite
밥	natural
방가	excite
방긋	excite
배고프다	angry
배반	angry
배부르다	excite
배신	angry
백화점	excite
버리다	natural
버림	sad
버스	natural
벅차다	excite
범죄	sad
병신	angry
병원	sad
보내다	natural
보너스	excite
보다	natural
보람	excite
보여주다	natural
보이다	natural
보잘것없다	sad
복수	angry
복잡하다	sad
부끄	excite
부담스럽다	sad
부드럽다	excite
부러지다	sad
부르다	natural
부재중	natural
부킹	excite
부탁하다	natural
분노	angry
분하다	angry
불만족스럽다	angry
불쌍하다	sad
불안하다	sad
불쾌하다	angry
불편하다	angry
불편하다	sad
불합격	angry
불행하다	sad
비극	sad
비난	angry
비색	sad
비싸다	angry
비절하다	sad
비참하다	sad
비탄하다	sad
비화	sad
빈둥	natural
빌리다	natural
빡쳐	angry
빡치게	angry
빡치다	angry
빨래	natural
뽀뽀	excite
뿌듯하다	excite
삐지다	angry
ㅅㅂ	angry
사고	sad
사기	sad
사라지다	natural
사랑	excite
사랑하다	excite
사망하다	sad
사장님	natural
사진	natural
삭제하다	natural
산뜻하다	excite
살맛나다	excite
살빠지다	excite
살쪘어	angry
살찜	angry
삶다	natural
상심	sad
상처	sad
상쾌하다	excite
새끼	angry
생각하다	natural
생기다	natural
생기있다	excite
생생하다	excite
생일	excite
서글프다	sad
서럽다	sad
서비스	excite
서운하다	sad
설거지	natural
설레다	excite
섭섭하다	sad
성가시다	angry
성괴	angry
성나다	angry
세다	natural
세일	excite
셀카	natural
소름끼치다	angry
소리내다	natural
소맥	excite
소외되다	sad
속상하다	sad
솔직하다	natural
쇼핑	excite
수고하다	natural
수술	sad
수심	sad
수업	natural
수치심	angry
술병	angry
숨기다	natural
숨다	natural
숨막히다	sad
스킨쉽	excite
슬프다	sad
시리다	sad
시발	angry
시밤	angry
시부럴	angry
시비걸다	angry
시원하다	excite
시키다	natural
시험	angry
신경꺼	angry
신경쓰다	sad
신경질나다	angry
신나다	excite
신선하다	excite
싣다	natural
실망하다	sad
실수	sad
실종되다	sad
실패	angry
심경변화	sad
심란하다	sad
심술	angry
심심하다	natural
심통	angry
싸다구	angry
싸대기	angry
싸우다	angry
싸움	angry
쌰랍	angry
쏘다	excite
쏘맥	excite
쒯	angry
쓰다	natural
쓰라리다	sad
쓰레기	angry
쓰리다	sad
쓸쓸하다	sad
씁쓸하다	sad
씨발	angry
씹	angry
씨발	angry
ㅇㅇ	natural
아가리	angry
아구창	angry
아놔	angry
아니꼽다	angry
아니다	natural
아닥	angry
아리다	sad
아무것도	natural
아빠	natural
아쉽다	sad
아싸	excite
아씨	angry 
아우껴	excite
아우꾜	excite
아웃겨	excite
아침	natural
아팡	sad
아푸다	sad
아프다	sad
아픔	sad
악성코드	angry
안녕	natural
안녕요	natural
안녕하세요	natural
안뇽	natural
안다	natural
안드로메다	angry
안쓰럽다	sad
안절부절	sad
안타깝다	sad
않다	natural
알겠엉	natural
알다	natural
알라뷰	excite
알랍	excite
알러뷰	excite
알려주다	natural
알아썽	natural
암담하다	sad
앗싸	excite
앙	natural
애달프다	sad
애련	sad
애상	sad
애석하다	sad
애원하다	sad
애이불비	sad
애절하다	sad
애정	excite
애처롭다	sad
애태우다	sad
애통하다	sad
애틋하다	excite
야	natural
야근	angry
야릇하다	excite
야속하다	sad
약	sad
약국	sad
약속	natural
약오르다	angry
어리다	excite
어예	excite
어이없다	angry
어제	natural
어플	natural
억울하다	sad
억장	angry
언니	natural
언짢다	sad
얻다	natural
얼굴	natural
엄마	natural
없다	natural
없애다	angry
엉망	angry
에휴	sad
여유롭다	excite
여자친구	natural
여친	natural
여튼	natural
역겹다	angry
연락하다	natural
연애	excite
연애인	excite
열광	excite
열받다	angry
열성	excite
열정	excite
열중	excite
염려되다	sad
염병	angry
영화	excite
예민하다	sad
예쁘다	excite
예썰	excite
예약하다	natural
옘병	angry
옛솔	excite
옛썰	excite
오늘	natural
오다	natural
오붓하다	excite
오빠	natural
오예	excite
오키	natural
오킹	natural
올라오다	natural
올리다	natural
옮기다	natural
와따요	excite
와우	excite
외롭다	sad
외우다	natural
요금	angry
우껴	excite
우끼다	excite
우울증	sad
우울하다	sad
욱하다	angry
운동	natural
운전하다	natural
울다	sad
울적하다	sad
울화	angry
울화통	angry
웃교	excite
웃기고있네	angry
웃기다	excite
웃기시네	angry
웃다	excite
웅	natural
원망스럽다	sad
원망하다	sad
원통하다	sad
월급	excite
위축되다	sad
윙크	excite
유감스럽다	sad
유쾌하다	excite
은근히	natural
음울하다	sad
음침하다	sad
응	natural
의기소침	sad
의욕넘치다	excite
의욕없다	sad
이따가	natural
이따구	angry
이별하다	sad
이뻐	excite
이쁘다	excite
이썽	natural
이태원	excite
이해안되다	angry
익사	sad
익숙하다	natural
인터넷	natural
일어나다	natural
읽다	natural
잃어버리다	angry
입다물다	angry
입력하다	natural
입원	sad
있다	natural
잊다	angry
자다	natural
자랑스럽다	excite
자살	sad
자신있다	excite
자전거	natural
잘생기다	excite
잘하다	excite
잠들다	natural
장례식	sad
장애	angry
장하다	excite
재미	excite
재밌다	excite
잼쩌	excite
잼쪄	excite
잼쪼	excite
적다	natural
전전긍긍	sad
전화	natural
절망하다	sad
젊다	excite
정겹다	excite
정말	natural
정신나가다	angry
져아	excite
졋같네	angry
졋같음	angry
졋까	angry
조금	natural
조급하다	sad
조까	angry
조바심	sad
조아	excite
조울증	sad
조으다	excite
조케따	excite
좃까	angry
좆같네	angry
좆같음	angry
좆까	angry
좆만하다	angry
좋겠다	excite
좋다	excite
좌절하다	sad
죳까	angry
주눅들다	sad
주다	natural
주룩주룩	sad
주먹	angry
죽음	sad
죽이다	angry
준비	natural
즐겁다	excite
증오	angry
증오하다	sad
지각	angry
지갑	natural
지겹다	angry
지금	natural
지랄	angry
지루하다	sad
지룰	angry
지우다	natural
지치다	sad
지하철	natural
질리다	sad
질색	angry
질질	sad
짜다	natural
짜릿하다	excite
짜증나다	angry
짜증남	angry
짜증스럽다	angry
짝사랑	sad
짱난다	angry
짱남	angry
쪼아	excite
찢어지다	sad
차였다	sad
차이다	angry
착잡하다	sad
찬성	excite
참담하다	sad
참사	sad
창피하다	angry
찾다	natural
채팅	natural
처량하다	sad
처연하다	sad
처절하다	sad
처지다	sad
처참하다	sad
천박	angry
체크	natural
쳐맞을	angry
초조하다	sad
최고	excite
쵝오	excite
추천	excite
추카	excite
축하	excite
출근	natural
출발하다	natural
충격	sad
충만하다	excite
충족되다	excite
취소	angry
측은하다	sad
치료	sad
치맥	excite
친근하다	excite
친밀하다	excite
친하다	excite
침울하다	sad
침통하다	sad
ㅋㅋ	excite
카톡	natural
칼퇴	excite
캬캬	excite
컴퓨터	natural
쾌활하다	excite
크크	excite
클럽	excite
키스	excite
키키	excite
타다	natural
태연하다	natural
택시	natural
토나와	angry
통곡하다	sad
통쾌하다	excite
통하다	excite
통화하다	natural
퇴근	natural
파티	excite
팝업	angry
패배스럽다	sad
평소	natural
포근하다	excite
폭락	angry
폭행	angry
폰	natural
푸근하다	excite
피곤하다	sad
피우다	natural
필요하다	natural
핑계	angry
ㅎㅎ	excite
하다	natural
하루	natural
하염	natural
하이	natural
하이요	natural
하찮다	angry
하하	excite
학교	natural
한강	natural
한맺히다	sad
한스럽다	sad
한심스럽다	sad
한턱	excite
행복	excite
행복하다	excite
허전하다	sad
허탈하다	sad
허하다	sad
헌팅	excite
헐	angry
헐랭	angry
헤어지다	sad
헤헤	excite
헬로	natural
호호	excite
혼나다	angry
혼란스럽다	sad
혼자	natural
홍대	excite
화나다	angry
화내다	angry
화딱지	angry
화이띵	excite
화장실	natural
화장품	natural
확인하다	natural
환불하다	natural
환희	excite
활기차다	excite
홧병	angry
홧팅	excite
황당하다	angry
황량하다	sad
황홀하다	excite
회식	excite
후리다	angry
후회하다	sad
후후	excite
훈훈하다	excite
흐르다	natural
흐뭇하다	excite
흑흑	sad
흔달다	natural
흔쾌	excite
흡족하다	excite
흥겹다	excite
흥미롭다	excite
희망	excite
히밤	angry
히히	excite
힘겹다	sad
힘내다	sad
힘들다	sad
힘빠지다	sad
힘없다	sad
힘차다	excite
힝ㅠ	sad
ㅗ	angry
ㅛ	angry
ㅜㅜ	sad
ㅠㅠ	sad
ㅡㅡ	angry
ㅡㅡ;	angry
미친	natural
미친새끼	angry
행복하지말아요	sad
너는내운명	love
할로할로!	happy
하이하이^^	happy
지금인나따아 ㅠㅠㅠㅠ	sad
ㅠㅠㅠㅠㅠ	sad
귀요미^^	love
귀요미인정	happy
일찍도인낫네ㅋㅋ	happy
그렇게일찍일어나서	sad
오늘은일찍일어났네	expect
꿀꿀한오후의	sad
굿모닝	happy
비오니깐잠이잘오네ㅋㅋㅋ	happy
비올때자는게꿀잠	happy
오늘또일나가	sad
올라온지10년정도됫네그럼?	natural
ㅋㅋㅋㅋㅋㅋㅋㅋㅋㅋㅋㅋㅋㅋㅋㅋㅋ 	excite
제대로 말안했어!	angry
이름 개명할꺼야ㅋㅋㅋㅋ	happy
내이름이 안좋대ㅠ	sad
너완전아니야	hate
먼소리야 ㅋㅋㅋㅋ	natural
여붕 일어나면 연락해줘~	expect
멘붕	angry
나오늘이사간다	 excite
엉덩이	excite
보면	natural
미치겠음	excite
이상형알고리즘의	love
수많은if문을통과한게	natural
너가처음이야	excite
건강해지자	expect
무섭다	hate
남자만나는거	love
당일치기	excite
주물러줘	expect
화장실이급해	angry
주말	happy
영화	excite
솔로라는게 	sad
함정	angry
청주	natural
전역한지	happy
3주됬어	natural
예비역중사	excite
예비역	excite
예비군	angry
심쿵	love
잘생겻서	expect
사랑입니다	love
부산남자	expect
나도힘든데	sad
다내려놓고싶어	sad
때려치고싶어	angry
나만힘들다한건아니잖아	angry
전화	natural
하지마	hate
목소리	natural
좋은사람	happy
목소리좋은사람	love
인정하자	expect
뱃살	natural
너희집근처	love
너보다	natural
내친구가	excite
대한민국	natural
만세	excite
눈물난다	sad
놀러가고싶어	excite
놀자	excite
아잉신나	excite
씐나	excite
돈없어,,,	sad
거지당	sad
그리워	sad
여보	love
수요일은 	natural
뭔가 어정쩡한 느낌	hate
목요일은 	natural
그냥 내가 왠지 싫어	hate
이번 주 금요일	natural
금요일에 시간 어때요	expect
주말까지 기다리긴 힘들어	expect
시간아 달려라 	excite
시계를 더 보채고 싶지만	expect
일분 일초가 달콤해	happy
이 남자 도대체 뭐야	expect
사랑에 빠지지 않곤	love
 못 배기겠어	excite
온 종일 내 맘은 	love
저기 시계바늘 위에 올라타	excite
한 칸씩 	natural
그대에게 더 가까이	love
딱히 보고 싶은 영화는 없지만	natural
딱히 먹고 싶은 메뉴는 없지만	natural
나 뭔가에 홀린 것 같아	excite
이 여잔 도대체 뭐야	excite
사랑해주지 않고는 못 배기겠어	love
돌아오는 이번 주 금요일에 만나요	expect
그 날 내 맘을 더 가져가줘요	expect
더 가까이 와요	expect
뭔가에	natural
홀린것	excite
내맘을	love
가져가요	expect
혼자있어도 	sad
난 슬프지 않아	happy
그대와의 추억이 있으니	love
하지만 깊은 허전함은	sad
추억이 채울수 없는걸	sad
언젠간 나없이도 	natural
살아갈 수 있을꺼야	happy
차가운 그대 이별의 말에	sad
할 말은 눈물뿐이라서	sad
바라볼 수 없던 나의 그대	love
하루하루 지나가면 익숙해질까	sad
두 눈을 감아야만 	natural
그댈 볼 수 있다는 것에	love
더이상 그대의 기쁨이 될 수 없음에	sad
나는 또 슬퍼하게 될꺼야	sad
하루하루 지나가면 잊을수 있을까	sad
그대의 모습과 사랑했던 기억들을	love
끝내 이룰수 없었던 약속들을	sad
아이러니함	excite
너없이도 살아갈수있을까	sad
너없이	sad
살아갈수있을까	sad
잊을수있을까	sad
느낌이 오잖아 	natural
떨리고 있잖아 	expect
언제까지 	natural
눈치만 볼 거니	expect
네 맘을 말해봐 	expect
딴청 피우지 말란 말이야 	angry
네 맘 가는 그대로 	love
내 손을 잡아	love
우연히 	natural
고개를 돌릴 때 마다	natural
눈이 마주치는 건	love
며칠밤 내내 꿈속에 나타나	love
밤새 나를 괴롭히는 건	angry
너와 나 말이야	natural
내 옆자릴 고르는 건	natural
나도 모르게 어느새	natural
실없는 웃음	happy
흘리고 있다는 건	natural
그럼 말 다했지 뭐 	natural
우리 얘기 좀 할까	natural
핸드폰 진동에	natural
 심장이 덜컥	sad
내려 앉는다는 건	natural
 짓궂은 네 말투	excite
자꾸 듣고 싶은걸	love
어떡해	expect
저기 멀리 걸어온다	natural
눈이 마주친다	love
언제까지 넌 모른척 할거니	angry
사랑이 온거야 	love
네가 좋아 정말 못 견딜 만큼	love
그거면 된거야 	natural
더는 생각하지 말란 말이야	angry
네 맘 가는 그대로	love
심장이 떨려	love
짝남	love
널사랑하게됬나봐	love
내 	natural
손을 	natural
잡아	expect
우연히	excite
눈이 	natural
마주친다	expect
며칠내내 	natural
꿈속에 	natural
나타나	love
밤새 	natural
나를 	natural
괴롭혀	hate
실없는 	natural
웃음	natural
얘기 좀 할까	expect
심장이 	love
덜컥	excite
자꾸 	expect
듣고 	natural
싶은걸	expect
어떡해	expect
한번 보면 두 번 더 보고 싶어	expect
두번 세번 보면 너를 더 안고 싶어	love
너와 커플링 손에 끼고서 	love
함께 이 길을 걷고 싶어	expect
매일 매일 봐도 	natural
난 더 좋아져 	love
두번 세번 	natural
나의 볼을 꼬집어 봐도 	excite
마치 꿈을 꾸는 듯 	happy
생각만 해도 난 미소가 	happy
입술 위에 츄 	love
달콤하게 츄 	love
온몸에 난 힘이 풀려	natural
내 맘 흔들어	love
날 흔들어놔요	love
널 보면 내 눈이 감겨	expect
몰래 살짝 다가와 	love
또 키스해줄래	love
내 꿈결 같은 넌	happy
부드러운 감촉 	happy
잊을 수 없어	love
화끈거리는 내 얼굴 	excite
빨개지는 걸 	excite
사랑스러워 	love
난 네가 자꾸만 좋아져	love
내 소원을 들어줘요	expect
영원한 사랑 이뤄주길	love
짜릿짜릿한 느낌 	excite
절대 맘 변하지 않기	expect
평생 나만 바라봐줘	expect
잊혀지지가않아	love
더보고싶어	expect
더안고싶어	love
커플링	love
소원	expect
소원은	expect
평생너만	love
너무 좋아서 	happy
생각만해도 기분이 좋아	happy
기분이 좋아 	happy
이 느낌 	natural
너만 느끼게 할 수 있는 느낌	excite
난 죽을때까지 느끼고 싶어	love
내 곁에 있어줘 	expect
아낄 수 있어	love
언제나 너만 바라봐	love
나도 모르게 괜히 웃음이 나와	happy
난 크게 소리 외치고 싶어	excite
좋아 	happy
니 모든 것이 좋아	love
머리부터 발끝까지	excite
조그만 행동까지 하나 하나	love
다 좋아 	love
니 모든 것이 좋아	love
너와 함께라면 즐거워 	happy
시간이 지날수록 더 좋아져	love
난 니가 필요해	expect
매일같이 있게 해달라고	expect
기도해	expect
행복하게 살수가 있어	happy
너와 함께면 	love
하루하루가 너무 특별해	excite
우리가 운명 아니어도	sad
난 무조건 너야 	love
언제나 너만 바라봐	love
난 절대로 떨어지기 싫어	hate
너를 보고 있어도 	natural
너무 보고 싶은걸	expect
내 곁에 항상 있어줘	expect
혼자있어도 	sad
난 슬프지 않아	happy
그대와의 추억이 있으니	love
하지만 깊은 허전함은	sad
추억이 채울수 없는걸	sad
언젠간 나없이도 	natural
살아갈 수 있을꺼야	happy
차가운 그대 이별의 말에	sad
할 말은 눈물뿐이라서	sad
바라볼 수 없던 나의 그대	love
하루하루 지나가면 익숙해질까	sad
두 눈을 감아야만 	natural
그댈 볼 수 있다는 것에	love
더이상 그대의 기쁨이 될 수 없음에	sad
나는 또 슬퍼하게 될꺼야	sad
하루하루 지나가면 잊을수 있을까	sad
그대의 모습과 사랑했던 기억들을	love
끝내 이룰수 없었던 약속들을	sad
아이러니함	excite
너없이도 살아갈수있을까	sad
너없이	sad
살아갈수있을까	sad
잊을수있을까	sad
꽃	happy
졸업	expect
스케이트보드	excite
크루져보드	excite
심플	natural
졸업식	expect
기분미묘	expect
사색의광장	natural
졸업가운	expect
사진찍고낼름오기	excite
졸업가운첨입어봄	natural
학교	natural
안녕	natural
전주	natural
전동성당	natural
daily	natural
영화	natural
암살	natural
신흥무관학교	natural
경희대학교	natural
병스타그램	natural
먹스타그램	natural
자취	natural
자취스타그램	natural
자취방	natural
저녁	natural
삼겹살	natural
된장찌개	natural
고기	natural
내가만든쌈장	natural
존맛	happy
배불러	happy
다이어트	angry
빠이	natural
짜이찌엔	natural
돼지되겠다	hate
캘리포니아	natural
칠레	natural
뉴욕	natural
제주	natural
여름휴가	excite
주문진	natural
낙지철판덮밥	happy
돈까스	happy
일상	natural
얼굴	natural
얼스타그램	natural
셀카	excite
셀기꾼	excite
셀피	excite
셀스타그램	excite
selfie	excite
selfie	excite
소통	happy
좋아요	happy
야식	expect
삼각김밥	natural
딸기우유	natural
배터지고	natural
죽자	sad
배터지고죽자	excite
휴가	excite
가평	natural
1박2일	excite
빨간머리	natural
경희대	natural
자대	natural
신호와시스템	hate
신시	hate
풀어주실분	expect
seoul	natural
서울	natural
서울시청	natural
월요일	natural
극혐	hate
박물관	natural
고궁	natural
죄다	natural
참치	natural
비빔밥	natural
맛있어	happy
자이제시작이야	expect
2주차	natural
여행에미치다	excite
제부도	natural
바다	natural
여름	natural
해변	natural
서해	natural
엠티	excite
볼살	happy
치킨	happy
chicken	happy
쏘맥	excite
소주	natural
맥주	natural
치킨여기	natural
개맛있음	happy
개맛잇음	happy
중앙대	natural
흑석동	natural
여기개맛있어	happy
여기개맛잇어	happy
술	sad
강남역	natural
짝	natural
역시	natural
친구	excite
우리는동창	excite
처음처럼	love
순하리	excite
복숭아맛	natural
복숭아	natural
디자인	natural
이쁘네	love
아침	natural
산책	natural
드라이브	excite
바다	natural
고픔	expect
명존쎄	angry
친구야	excite
혹시	natural
명치	natural
쎄게때리고싶다	hate
쎄게	natural
때리고	angry
싶다	expect
와인	excite
추억	natural
10년칭구	excite
전화	natural
해준다면서	expect
안해주냐	sad
전화해준다면서	expect
ㅜㅜ	sad
ㅠㅠㅠㅠ	sad
우리집은	natural
남자만	natural
넷	natural
여자없음	natural
얼굴보단	natural
성격	natural
나도	natural
그만하고싶은데	sad
맘이	love
내맘대로	natural
않되	sad
안되	sad
내맘대로안되	sad
내가좋아하는애가	love
날좋아한대	happy
기적	happy
기적이라는말	happy
듣고싶어	expect
기분좋은말	happy
ㅋㅋ	happy
퇴근	excite
퇴근시간은	excite
다가오는데	expect
일은	natural
남았네	sad
콩나물국밥	natural
내가좋아하는말	happy
근데장염걸렸다	sad
사디스트	sad
첫사랑	love
끝난썸	sad
나만	natural
그런거니	natural
잘생긴	excite
사랑해요	love
뭔데	natural
귀엽냐	love
아니	natural
알아요	natural
마지막	natural
3년기다릴께	love
3년기다릴게	love
다시만나자	love
사랑해	love
결정장애	natural
도와줘	expect
여자	natural
성별	natural
그래도	natural
파이팅하자	expect
파이팅	expect
남자라서	natural
걔가	natural
나	natural
관심없어하면	sad
어떡해	natural
곤약	natural
진짜	natural
오늘	natural
너무	natural
덥다	angry
살짝	natural
흔들린다	sad
왕따	sad
짝사랑	sad
거북선	natural
앤덥이	natural
제일	natural
나만그런가	natural
유전때문에	natural
태어날때부터	natural
거칠거칠	natural
나혼자	sad
위로	happy
부끄러운데	expect
고맙습니다..	happy
고맙습ㅁ니다..	happy
눈보고	natural
웃어줘ㅛ당	happy
웃어줬당	happy
ㅎ	happy
보고싶어	expect
보고시퍼	expect
통화중	natural
졸려	natural
담아두고	natural
담아두다가	natural
얘기하는거에요	expect
이야기하는거에요	expect
종이학	love
얼굴밖에모르는사이	natural
엑소	excite
소개	excite
이제	natural
그만	hate
현실을	natural
바라보라고	expect
심심해	natural
심심하니까	natural
지루함	natural
오빠	excite
아침마다그노래를들으면	natural
점점싫어진다	hate
flake	natural
개맛있음	excite
외롭다ㅠ	sad
외롭다	sad
그날처럼	natural
널보내지않을꺼야	love
딥빡	angry
스킨십	love
엄마	love
나쁜년	hate
나쁜새끼	hate
거지같은새끼	hate
거지같아	angry
나쁜놈	hate
누나	excite
첫사랑	love
선톡	excite
교회오빠	love
다이어트	angry
카톡	excite
싫엉	hate
나랑톡하장	happy
오랜만에	natural
교복을입는데	expect
교복이헐렁함	excite
너말이야	natural
너	natural
뭔지모를	natural
죄책감	sad
죄책감이랄까	sad
같은글자	natural
다른의미	natural
포기	sad
포기해야할때	sad
연락안올꺼아는데	sad
에휴	sad
넌	natural
신경이나쓸까	angry
교수님	natural
나빠요	hate
신촌을못가	sad
혼자	sad
썸	love
행동하나하나	natural
설레이니까	love
난왜…	sad
남들은	natural
받았다던데	natural
심심하다	natural
한번만	natural
안아보자	expect
대전	natural
편해진남자	natural
미워	sad
좋다고	love
말을해	expect
연애의발견	love
연애말고결혼	love
연애	love
결혼	love
번호따였음	excite
알아가자우리	expect
연하	love
바로	natural
너	natural
바로너	love
외롭다ㅠ	sad
외롭다	sad
이제	natural
더 이상	natural
오지않겠지…	sad
내가	natural
무슨	natural
병균이냐	hate
깐족	hate
깐족쟁이	hate
그냥	natural
친한	natural
오빠랑	excite
이러면	natural
안되는거지…	hate
이마에뽀뽀	love
어깨동무	love
손잡구	love
팔장끼구	love
백허그	love
팔베게	love
포옹	love
허리에손올림	love
냉면	natural
듭네	angry
더워	hate
덥다	angry
그린라이트이길	expect
그린라이트	love
배고파	angry
퇴근좀	angry
민방위훈련	natural
프사	natural
상메	natural
까칠한	hate
입술	love
남친도	love
있는데	natural
썸남	love
그린라이트일까?	expect
왜연락했니?	expect
고백	expect
무서운건	sad
좋아하는	love
멀어지는게	sad
무서워서	hate
너랑	natural
고백하는게	love
내맘은	natural
보고싶다	expect
나좀	natural
잡아줘	sad
그땐	natural
미웠지만	hate
그땐미웠지만	hate
미워하지말아요	sad
제첫사랑은	love
이미행복하네요..	happy
어느날	natural
갑자기	natural
절망	sad
초조	hate
불안	hate
시므시므해	natural
소개팅녀	love
다신안해	angry
흐앙	sad
내옆구리살	natural
알면서	natural
울지말고	angry
나한테	natural
얘기해	natural
아무렇지않은척	sad
힘드네	sad
힘내자!	happy
하앜	natural
무기력	sad
업어줘	expect
우동먹고싶다	natural
외롭	sad
완전귀여워	love
귀여워	love
예쁜데	happy
너도날	natural
조금이라도	natural
생각했으면	expect
한숨만	sad
늘어가네	natural
신이시여	expect
용기를	expect
주소서	expect
수치야	hate
부럽다고	expect
하지마	angry
좋다좋아좋군	happy
섬유유연제향	happy
설레이자나	expect
남자에게서	love
나는향	love
여친좀	expect
밥줘	natural
난없어서마음에안들어…	hate
성에안차	hate
환영	excite
파이팅	happy
검정고시	natural
일하기시러	hate
답답해	angry
갖고싶다	expect
졸리다	natural
순수청년	happy
사랑해요	love
안기고	love
싶다	expect
안아줘요	expect
노래방	excite
나이먹고	natural
친구만들기	natural
정말	natural
어렵다	sad
그런데말이야	natural
나너한테설레고있다	love
연락해주겠니	expect
계곡	natural
유럽	natural
지친다	sad
첫이별	sad
너무힘들다	sad
이별은	sad
언제나	natural
힘들다	sad
시간이	natural
약	natural
벌	hate
벌받아라	hate
쓰레기	hate
행복해	happy
행복하다	happy
차라리	sad
모를때가	natural
더	natural
행복했어…	sad
궁금한데	expect
용기가않나	sad
꿀꿀하다	sad
난우정	excite
우정	excite
연애중	love
남친	love
보고싶어	expect
죽겄어	hate
새벽	natural
새벽세시	natural
비올떄	natural
자는게	natural
꿀잠	happy
불금엔클럽	excite
클럽	excite
즐거웠다	sad
먹방커플	excite
술땡긴다	sad
너때문에	natural
너를사랑한시간	love
캬아	excite
우리사랑해도될까요	love
우리	natural
사랑해도	love
될까요	expect
행복했다	sad
비가	natural
오네	natural
게임	excite
시간이약	sad
시간이약이다	sad
날조금이라도생각했으면	sad
넌너무귀여워	love
울지말고얘기해	angry
마음이아프잖아	sad
불안초조	excite
우리집은남자만넷	excite
맘이내맘대로안되	sad
나만그런거니	sad
나만그랬던거니	sad
기다릴께	sad
다시만나주면	expect
안되겠니	sad
꺼져주면	hate
꺼져	angry
자존심상해	angry
예쁘다	love
예쁘네	happy
너예쁘다	love
멀어지기싫어	sad
진짜짜증나	angry
미친놈같아	hate
미친놈	hate
ㅋㅋ	excite
빡친다	angry
꺼져줄께잘살아	angry
슬프다	sad
바보	hate
바보같은놈	hate
멍청한새끼	hate
바보같은새끼	hate
슬퍼	sad
슬픔	sad
어떻게 말할까 	natural
수백번 생각하느라	love
잠을 설쳐서 	angry
얼굴도 엉망이고	angry
오늘따라 머리까지 	natural
맘에 안들어	hate
하루종일 안절부절	sad
어느새 	natural
너를 만나기 한 시간전	love
꽃집에 들러 	happy
꽃을 좀 사려는데	happy
장미를 살까 	natural
다른 꽃 살까	natural
에라 모르겠다 	natural
아줌마 이쁘게 해주세요	happy
오늘은 널 만나면 	love
이쁘다고 말하려 했는데	love
얼굴보자마자 	natural
내가 꽃 	happy
니가 밥사	expect
어쩜 이런 말만 나와	angry
도대체 멍청한건지 	angry
순진한건지	happy
이렇게 한심한 	sad
말만 튀어나와	angry
사실은 내가 하려했던 말은 말야	love
난 널 사랑해	love
밤새워 연습했던 말 	love
다 잊어버리고	sad
멋 없이 그냥 건넨 	sad
꽃다발에도	happy
밝게 웃어주던 많이 좋아하던 	happy
넌 천사야	love
밥먹고 	natural
이런 저런 	natural
얘길나누며	happy
언제 말할까 	expect
기회만 엿보다가	expect
지금할까 지금이야 사실 	expect
나 이젠 아무것도 안들려	sad
내맘은 너 아니면 안된다고 	love
말하려 하는데	natural
둘 다 외로운데 한번 만나볼래 	love
계속 이런 말만 나와	natural
부드럽게 무드있게 따뜻하게 	love
꼭 안아주시오	love
매일 한 번씩 사용하시오	love
부드러운 눈 마주칠 땐 미소 지어서	love
그녀를 웃게	love
말을 거시오	happy
그날 아침엔 먼저 일어나서	happy
널 바라봐	love
너무 지칠 땐 소주 두 병 들고	sad
솔직하게 그녀의 집 두드리시오	expect
가끔 한 번씩 무작정 	natural
같이 떠나가시오	expect
다른 하늘 다른 바람 	natural
숨 쉬게 해줘	expect
가끔 한 번씩 	natural
무작정 키스해주시오	love
이유 없이 너에게 빠진 그 날처럼	love
사랑해	love
잘 때는 나긋하게 	love
조용하게 눈물 나게 말해주시오 	sad
매일 한 번씩 너무 고마워	love
좋아해	love
썸 널 깨우고 	love
바래다줄 땐 발걸음 천천히	love
그녀에게 고백하시오	love
다른 여자 앞에선 이성적이지만	natural
이상하게 너 앞에선 감정이 앞서	love
널 사용하기엔 너무나 아까워	love
마냥 바라보기엔 넌 날 미치게 해 	love
영원히 널 사용하고 싶어	love
하늘의 별을 따다 박아놓았네 	love
너의 두 눈	love
조그맣고 앙증맞아 	love
귀여워 	love
오똑한 코를 볼 땐 나 미칠 것 같아 	love
끝판왕까지 깨보고 싶은 맘 굴뚝	love
네 앞에선 되어줄게 미련한 곰	love
내 것 건드리면 나 무서운 호랑이로 변해 	angry
화나게 하지마 우리 둘 지나갈 땐 	angry
길을 막 길을 막지마	angry
화난다	angry
새로 생긴 버릇 너만 보는 버릇 	love
네게 눈을 뗄 수 없어 어쩔 수 없어	love
자기 얼굴 보며 맘에 안 든다며 	sad
살이 쪘다	angry
희망	expect
화장 지워도 예뻐 뭐를 입어도 예뻐 	love
내 눈엔 네가 정말 예뻐	love
아무리 봐도 예뻐 수백 번 봐도 예뻐 	love
네가 제일 예뻐	love
사랑하는	love
웃을 때 쏙 들어가는 보조개와 	love
나를 위해 하는 행동	love
굳이 긴 말이 필요하지도 않아 	love
햇빛	happy
숨겨도 어쩔 수 없어 넌 빛이 나지 	love
이리 봐도 예쁘고 저리 봐도 예뻐	love
오 지금 내가 헤퍼	sad
눈물	sad
새로 생긴 버릇 너만 보는 버릇 	love
네게 눈을 뗄 수 없어 어쩔 수 없어	love
자기 얼굴 보며 맘에 안 든다며 	angry
살이 쪘다며 이 바보야 너	angry
기대할게	expect
화장 지워도 예뻐 뭐를 입어도 예뻐 	love
정말 예뻐	love
아무리 봐도 예뻐 수백 번 봐도 예뻐 	love
보석같은 너	love
바보	angry
혹시 멀어질까 봐 더 이상 다가가기 힘든데 	sad
혹시 달아날까 봐 감추고 있단 걸 알고 있나요	expect
싫어	hate
화장 지워도 예뻐 뭐를 입어도 예뻐 	love
너와 함께	love
이제 난 너 없이는 의미도 없지	sad
영원을 지나 같이 있자	love
사랑한단 말 내겐 너뿐이란 말 어쩜 말로는 다 못해	love
언제까지나 같이 있자	love
한참을 헤매다 	sad
널 몰라 봤던 나	sad
아침에 내 창에 비추는 	love
저 햇살처럼	love
나는 듯한 이 기분 이런 게 사랑일까	love
아무런 의미도 없지	sad
어떤 사람을 만나는 거니 물을 때	natural
좋은 사람을 만나게 된 거지 대답 해	love
달콤해	happy
즐거워	happy
자랑하고픈 다 말을 하고픈 기분에	happy
친구들을 모아 몇 시간을 떠들기만 해	excite
내 사랑은 너 그래 바로 너	love
하루에도 열 두 번	natural
보고 싶다고 하며	love
내 전화기를 바쁘게 하는 너	love
나를 사랑해 줘서 고마워	love
내가 너보다	natural
내가 너보다	natural
힘들어	sad
사랑해 사랑해	love
좋아해 좋아해	love
뽀뽀	love
바보 같아도	angry
짝사랑	love
유치해 보여도	natural
너와 같이	love
행복해 행복해	happy
햇빛이 강하다	happy
비가 온다	sad
전부 주고픈 다 해주고 싶은 마음에	love
적어 놓은 것들 언제 다 해주나 걱정 돼	sad
내 사랑은 너 그래 바로 너	love
눈을 감아도 느껴지는 너	love
하루에도 열 두 번	natural
보고 싶다고 하며	love
내 전화기를 바쁘게 하는 너	love
나를 사랑해 줘	love
내 왼 쪽에	natural
내 오른 쪽에	natural
영원히 두고 싶은 건 너야	love
언제까지나	love
내 사랑은 너 그래 바로 너	love
눈을 감아도 느껴지는 너	love
사랑 할 땐 반드시	love
꼭 필요한 레시피	natural
유통 기한이 안 적힌 내 진실	love
사랑이란 특별한 요리	love
결혼할까요 	love
그대의 작은 목소린 	love
무엇보다 내게 큰 힘이 돼죠 	love
세상을 등지고 싶을때 	sad
그대의 작은 어깨에 기댈때면 	expect
난 다시 꿈을 꾸죠	expect
희망이란 놈을 찾죠 내 두 눈에 	expect
항상 그댈 담고 싶네요 사랑해 	love
푸른 하늘 보다 더 넓은 바다 보다 	happy
더 그댈 사랑 할 수 있는 나에요 	love
세상 어떤 말도 부족하지만 그대에게 전하고 싶은 말 	love
그대를 사랑할께요 	love
영원히 지켜줄께요 	love
처음과 같은 맘을 매일 선물할께요 	love
한 여름날에 눈이 내릴때까지 	happy
나의 사랑 변하지는 않아요 	love
평생 행복을 안겨줄 소중한 사람이예요 	love
지금 꼭 잡은 두 손 다시는 놓치지 마요 	love
약속해줘요 항상 같은 자리에 	love
나와 함께 하기를 	love
알고있나요 	natural
그대 때문에 사랑하는 법을 배웠어요 	love
우는것조차 모른던 내가 	natural
당신이 아파 할때면 눈물이나요	sad
아프지 마요 언제나 웃어요 	expect
약속할께요 그대만을 사랑해요 	love
나와 결혼해줘요 	love
거친 파도가 와도 먹구름 밀려와도 	sad
내사랑은 그대와 함께하죠	love
어두운 밤에 그대 길 잃어도 	sad
내 사랑이 환하게 비추죠 	love
나나나나나 나나 나나나나나 나나 나나나나나	excite
그댈 사랑해요 	love
서쪽 하늘에 해가 뜨는날까지 	happy
그대만을 사랑하고 싶어요 	love
내 행복을 다 잃어도 세상 눈물 다 가져도	sad
지금 꼭 잡은 두손 다시는 놓치지 마요 	expect
약속할께요 	expect
세상 누구보다 더 그댈 사랑할께요 	love
아이처럼 자꾸 설레는 	love
눈부신 그대가 보여요	love
파도처럼 벅차 오르는 	happy
상쾌한 아침이 좋아요	happy
실바람 타고 	happy
나부낀 꽃 내음이 그대 곁에 맴돌다 	love
나를 부르네요 	expect
두근 거리는 우리 사랑 해봐요	love
세상모든게 아름다워요 	love
그대를 따라 햇살도 춤을 추네요 	love
그대여 언제나 함께 해줘요	love
달달한 미소로 내게 인사하죠 	love
나의 고백을 들어줘요	love
디디디 디디디 디디디	happy
두근대는 기분 좋은날 	love
달콤한 사랑이 오네요	love
콧 노래나는 하루를 시작해요 	love
들어본적없었던 	natural
그런 멜로디죠 알고 있나요 	expect
우리 사랑의 노래 	love
세상모든게 아름다워요 	love
그대를 따라 햇살도 춤을 추네요 	love
그대여 언제나 함께 해줘요	love
달달한 미소로 내게 인사하죠 	love
나의 고백을 들어줘요	love
곁에있어도 멀리있어도	expect
예뻐 보여요 뛰는 가슴도	love
내 작은 떨림도 오직 그대 때문인걸요	love
세상 모든게 아름다워요	love
그대를 따라 햇살도 춤을 추네요 	love
그대여 언제나 함께 해줘요	love
그대와 마주걷는 이 길 위에서 	love
나 한번 더 네게 말해요	love
잘해준 것 밖엔 없는데 	sad
잘해준 것 밖엔 없는데	sad
시간이 지나면 지날수록 	sad
점점 넌 차가워지고	sad
차갑다	sad
잘해준 것 밖엔 없는데 	sad
잘해준 것 밖엔 없는데	sad
시간이 지나면 지날수록 	sad
점점 넌 변해만 가고	angry
사랑이 변했다	angry
넌 나랑 왜 만나니 	angry
그렇게 내가 쉬워 보였니	angry
주긴 싫고 갖긴 싫은 	angry
그런 사람이 나였니	natural
쉬워보이니	angry
사랑한 적 없다고 말해도 	angry
싫다고 말해도 	angry
왜 네가 좋은 건지 	love
내가 더 잘할게 	expect
잘할게	expect
잘해준 것 밖엔 없는데 	sad
잘해준 것 밖엔 없는데	sad
시간이 지나면 지날수록 	sad
점점 넌 변해만 가고	sad
변한 사랑	sad
넌 나랑 왜 만나니 	angry
그렇게 내가 쉬워 보였니	angry
주긴 싫고 갖긴 싫은	angry
그런 사랑이 나였니	natural
참으려 해도 웃음이 나와 	happy
샴페인이 터지듯	happy
좋아 낮은 목소리 	love
장난스러운 그대 걸음도 	love
왜 이렇게 왜 이렇게 좋아요 	love
웃게 해줄게 서툴겠지만 	love
그댈 위해서만	love
그대 이름 혀끝에 녹아 내릴듯 달아요 	love
그댈 몰랐다면 몰랐어요 	natural
이런 기분을 이런 행복을	love
왜 이렇게 왜 이렇게 좋아요	love
웃게 해줄게 서툴겠지만 그댈 위해서만	love
생각만 해도 아파요 나를 떠나면 안되요 	expect
그대 없었다면 없었어요 	sad
이런 노래도 이런 사랑도 	love
부끄럽게 간지럽게 이대로 	love
아무것도 숨기지 마요 	expect
믿게 해줄게 언제까지 그댈 사랑해요 	love
우 감추려해도 다 보이나 봐 햇살이 퍼지듯	love
이런 바보같은 날 온 세상이 다 놀려도 좋아	love
기다리란 말만 하면서 외면했죠 	sad
오랜 시간	natural
조금 기다리면 그때가 올 거라고	expect
그대 원하는 그 말을 다 알면서	expect
얼마나 오래 기다린 줄 알면서	expect
이제야 말하네요	natural
울지 말아요 고개 들어봐요 	sad
이젠 웃어 봐요	happy
행복만 줄게요	love
언제나 그대 곁에서 영원히	love
모두 잘 될 거에요	happy
고마워요 이런 날 믿고 기다려준 그대	love
미안하단 말보다 먼저 하고픈 말이죠 	expect
그대에게만 전해 주고 싶던 말	love
하지만 결국 하지 못했던 그 말 	sad
나와 결혼해줘요	love
기다림 속에 흘린 그대 눈물을 알기에	sad
이젠 돌려 줄 거에요 그대 사랑을	love
울지 말아요 고개 들어봐요 이젠 웃어 봐요	expect
무더운 밤 잠은 오지 않고	sad
이런저런 생각에 불러 본 너	expect
나올 줄 몰랐어	natural
간지러운 바람 웃고 있는 우리	love
밤하늘에 별 취한 듯한 너	love
시원한 맥주	happy
바랄 게 뭐 더 있어	happy
한여름밤의 꿀	happy
한여름밤의 꿀	happy
정말 오랜만이야 어떻게 지냈어	expect
나 똑같지 뭐 그냥 열심히 일했어	natural
넌 어때 그때 그 사람 계속 만나	natural
헤어졌구나 미안	sad
괜한 얘기 꺼내 어쨌든 반가워	expect
시간 진짜 빠르다	sad
벌써 여기까지 왔네 우리도 근데 어쩜	natural
근데 어쩌면 넌	natural
하나 변함없이 여전히 예쁘네	love
던진 농담 반 진담 반 왜 말 돌리는데	natural
술 때문인 건지 아니면 부끄러운 건지	love
빨개지는 볼 너 생각나	love
피어나는 추억의 화원	happy
색색 아련한 이야기꽃 웃음꽃	happy
예전에 나 너 좋아했던 거 알어	love
나 좀 취했나 봐 헛소리 신경 쓰지 말고	natural
건배 오늘처럼	happy
무더운 밤 잠은 오지 않고	sad
이런저런 생각에 불러 본 너	expect
나올 줄 몰랐어	natural
간지러운 바람 웃고 있는 우리	love
밤하늘에 별 취한 듯한 너	love
시원한 맥주 건배	happy
바랄 게 뭐 더 있어	happy
한여름밤의 꿀	happy
한여름밤의 꿀	happy
지금 나오는 노래 뭐지 잠깐	natural
알 듯한데 제목 기억 안 나는 옛 노래	happy
흥얼거려 멜로디 시원한 밤공기	happy
자리 옮길 겸 걷자 신 난다며	happy
폴짝 뛰어가는 뒷모습 참 순수해 너란 여자	love
그러다 벌레 한 마리에 기겁하더니	angry
가로등 불빛 아래 포개지는 그림자	happy
하나 이 순간	happy
둘 행복해	happy
셋 어느새 쥐고 있는 손가락	love
넷	natural
한여름밤의 꿈 깨고 싶지 않은	happy
한여름밤의 꿀 바로 오늘 같은	happy
바랄 게 뭐 더 있어	happy
한여름밤의 꿀	happy
한여름밤의 꿀	happy
오늘 너무 즐거웠어	happy
너무 반가웠어	happy
잘 자 굿 나잇	happy
바랄 게 없어서 행복했어	happy
너무 행복했어	happy
잘 자 굿 나잇	happy
바랄 게 뭐 더 있어	happy
사랑엔 언제나 힘겨웠던 내 삶 	sad
버려진 우산 그처럼	sad
난 항상 추위와 고독 또 심한 모독	sad
그 모든 걸 다 견디며 	expect
여러 번 쉽게 차이며 	sad
진짜 사랑을 찾아 떠돌던 방랑자	sad
하지만 그 발걸음을 멈추게 한 	expect
아리따운 낭자 	love
너를 내 가슴에 새긴 후로 	love
내 삶은 끝없은 활주로	happy
난 다시 태어났어 	happy
붉은 낯으로 피어난 꽃으로	happy
수줍은 미소 	love
부드러운 두 손 	love
니 눈빛이 날 홀려 	love
이 가슴을 막 울려	love
늘 변함없이 날 감싸주니 	love
저 들판 위에 꽃도 어둠 속에 달도 	happy
날 보며 질투해	angry
너를 만나기 전 내 삶은 가시덤불 	sad
하지만 이젠 튼튼한 건물	happy
너무도 큰 사랑에 웃기만 하는 	love
나는 바보 온달 	love
저 둥근 달 보다 내 삶이 더 밝아	happy
니 모습은 마치 햇살이 내려 앉은 창가 	love
니 속삭임은 마치 할머니의 자장가	love
그걸 생각하니 그저 모든 게 평화로와 	happy
이 세상 가장 아름다운 조화 그것은 바로 너와 나	love
너로 인해 난 이렇게 행복한데 	happy
그에 반해 난 네게 해줄 수 있는 건 팔 베개	love
껴안아줄 수 있는 것 밖에 없어 	love
미안해 	sad
니 안에 내 자릴 마련해 준 네게	happy
앞으로 나 신발이 되어줄게 	love
날 신고 어디든지 가 	happy
더러운 걸 밟아도 걱정 마 	happy
아무도 눈치 못채게 내가 다 감싸줄게 	love
그 대신 죽을 때까지 내 옆에 있어 약속해	expect
우리 사랑하지 말아요 	sad
아직은 잘 모르잖아요	natural
사실 조금은 두려운 거야 	sad
그대 미안해요	sad
우리 약속하지 말아요 	expect
내일은 또 모르잖아요	expect
하지만 이 말 만은 진심이야 	love
그대 좋아해요	love
아무것도 묻지 말아요	natural
대답할 수 없어요	natural
지금 이렇게 둘이 행복한데 왜	happy
날 가지려 하지 말아요	expect
그저 이대로 조금만 있어요	expect
갈수록 더 마음 아파지게 왜	sad
잦은 만남 뒤엔 이별	sad
계속 반복되는 실연	sad
더는 의미를 찾을 수 없어 어리석은 미련	sad
사랑의 탈을 쓴 실수	sad
느끼는 감정은 다 비슷해	natural
하지만 이 순간만큼은	happy
우리 사랑하지 말아요 	sad
아직은 잘 모르잖아요	natural
사실 조금은 두려운 거야 	sad
그대 미안해요	sad
우리 약속하지 말아요	expect
하지만 이 말 만은 진심이야 	love
그대 좋아해요	love
나를 보며 웃지 말아요	sad
정들면 슬퍼져요	sad
예쁜 그 미소가 눈물이 될까 봐	sad
사랑이란 두 글자 속에	love
우릴 가두려고 하지 말아요	natural
채우지 못할 욕심이니까	sad
처음엔 설렘을 안고	love
끝엔 서로 의리로나마 지내 시행착오	sad
난 하루하루가 불안해	sad
하지만 오늘 밤만큼은	expect
내게 너무 많은 걸 바라지마	expect
나도 그댈 잃고 싶진 않아	expect
깊어지기 전에 상처 입기 전에	sad
날 믿지 말아요	expect
넌 항상 그래	natural
이기적인 새끼	hate
우리 사랑하지 말아요 	sad
아직은 잘 모르잖아요	natural
사실 조금은 두려운 거야 	sad
그대 미안해요	sad
우리 약속하지 말아요 	expect
내일은 또 모르잖아요	expect
하지만 이 말 만은 진심이야 	love
그대 좋아해요	love
궁금해서 잠이 안 와	sad
그때 왜 그랬어	sad
구차해도 묻고 싶어	sad
그때 난 뭐였어	sad
뭐였어	sad
나만 애 탄거니	sad
구차하다	sad
난 진심인데 넌	love
그랬구나 그랬어	natural
좋았는데 넌 아니었나 봐	sad
그랬구나 그때 넌	natural
그런 줄 모르고 나 혼자	sad
이럴 거면 바래다주었던 그날 밤	natural
넌 나를 안아주지 말았어야지	sad
설렘에 밤잠 설치게 했던 그 말	love
그 말도 말았어야지	sad
그러지는 말지	sad
비겁하게 숨어버린 너를	angry
돌아 올 거라고 믿은 내가 바보야	sad
사랑스럽게 날 보던 네 눈빛에	love
빠졌던 내가 바보지	sad
이럴 줄도 모르고	natural
이렇게 돼 버린 이상	natural
그냥 얘기할게	natural
이미 떠나버린 니 맘	sad
돌릴 순 없으니	sad
그랬구나 그랬어	natural
좋았는데 넌 아니었나 봐	sad
그랬구나 그때 넌	natural
네 생각 뿐인데 나 혼자	love
이럴 거면 바래다주었던 그날 밤	natural
넌 나를 안아주지 말았어야지	sad
설렘에 밤잠 설치게 했던 그 말	love
그 말도 말았어야지	sad
이럴 줄은 몰랐어	sad
어때 넌 어떻게 하고 싶니	natural
지금 이 순간의 감정일지	love
중간에 금방 에러가 날것인지	sad
하지만 내 생각엔	natural
오래가진 못할 거 같아	sad
너 아닌 나 때문에	natural
이 관계는 이어지지 못해	sad
잠 못 들어 아픈 이 새벽	sad
잘 지내니 문자 한번쯤은 해주지	expect
혹시나 하며 올린 우리 얘기에	expect
좋아요 누르지 말지	sad
괜히 기대 하게	expect
바래다주던 그 날 밤처럼	love
돌아와서 포근하게 나를 안아줘	love
설렘에 밤잠 설치게 했던 말로	love
또 두근거리게 해줘	expect
다시 날 녹여줘	expect
이럴 거면 귀엽다고 하지 말지	sad
그러지 말지	sad
혼잣말만 늘어가네	sad
전하지도 못할 말만	sad
벌써 넌 내가 편하니 	sad
웃으며 인사	happy
까맣게 나를 잊었니 	sad
네 곁에 있는 사람 소개할만큼 	natural
견디긴 너무 힘든데 	sad
자꾸만 울고 싶은데 	sad
내 옆이 아닌 자리에 	sad
너를 보고 있는게 	happy
왜 그게 행복한걸까 	happy
친구라도 될 걸 그랬어 	expect
모두 다 잊고서 	sad
다른 사람 만나는 널 보아도 슬프지 않게 	sad
그저 바라보고 있었어 한참동안 	sad
네 옆에 그 사람까지도 잠시라도 더 보려고 	sad
다시 혹시라도 널 보게되면 	expect
그땐 모르는 척 해볼게 웃어도 볼게 	expect
지금의 너처럼 	natural
눈 감지 말고 보낼 걸 가는 널 꼭 지켜볼 걸 	expect
차가운 너의 걸음에 	sad
마지막 내 눈물도 묻혀서 보내버릴 걸 	expect
너무 모진 너의 모습이 미워져버렸어 	sad
다른 사람 만나는 널 보아도 슬프지 않게 	sad
그저 바라보고 있었어 한참동안 	sad
네 옆에 그 사람까지도 잠시라도 더 보려고 	sad
다시 혹시라도 널 보게되면 	expect
그땐 모르는 척 해볼게 	expect
웃어도 볼게	expect
차라리 잘된 것 같아 	expect
다시 널 또 한번 미워할 수 있을테니	sad
미워	angry
혹시 아직 너도 나처럼 편해지지 못하고 	sad
아파만 하는 거니 애써 너도 참는거니 	sad
혹시 네가 다시 돌아올까봐 	expect
나의 곁은 아직 그대로 비워져 있어 	expect
너의 자리라서	natural
사랑을 선물했더니 이별을 주려하다니	sad
이런 사람이었니 너 왜 이렇게 못됐니	angry
나만 사랑한다면서 	love
우리 사랑 모두 거짓말이니	sad
니가 내게 이럴 줄 몰랐어	sad
여자의 마음을 왜 이렇게 모르니	sad
마음을 도대체 알수가 없어	angry
너는 내 남자이니까 니가 내 사랑이니까	love
다 미안해 다 이해해 헤어지지 말자	sad
밤 늦도록 술 마신다고 담배 좀 그만 피라고	angry
귀찮은 잔소리도 하지 않을게 	expect
미워도 사랑하니까	love
성격이 조금 급하고 속이 좁은 여자란 걸 알잖아	sad
고치려고 노력도 해볼게 	expect
화장기가 없는 맨 얼굴을 좋아한 너	love
거울을 보다가 눈물로 다 지웠어	sad
너는 내 남자이니까 니가 내 사랑이니까	love
다 미안해 다 이해해 헤어지지 말자	sad
주말에 영화 보자고 늦으면 전화하라고	expect
귀찮은 잔소리도 하지 않을게	expect
미워도 사랑하니까	love
도대체 니가 얼마만큼 잘난 놈이길래	angry
왜 이렇게 대체 내 마음을 몰라주는데 날 아프게 하는데	sad
늦어도 괜찮으니까 좀 늦어도 괜찮으니까	expect
꼭 돌아온단 약속만 해줘	expect
미워도 사랑하니까 미워도 사랑하니까	love
아파도 사랑하니까 너는 내 남자이니까	love
니가 날 안아줘야 해	expect
모든 걸 다 알면서도 	natural
속고 또 속아주는게 여자의 마음인 걸 모르니	sad
아파도 사랑하니까	love
미워도 사랑하니까	love
헤어진 다음날 니 목소리 없이 	sad
아침에 혼자 눈을 뜨게 된거야	natural
실감이 안나 전화기를 켜보니 	sad
니 사진은 우리 둘 사진은 	natural
그대로 있는데 여기있는데	natural
어떻게 벌써 보고 싶은데	expect
이젠 지워야겠지 모두 지워야 겠지	sad
웃는 너의 사진을 행복한 우리 사진을	love
한장씩 너를 지울때 마다 가슴이 아려와	sad
너의 사진이 점점 흐려져	sad
사진 속 너를 불러도 보고너를 만져도 보고	love
너무 잔인한 일이야 너를 지우는 일	sad
그대로 있는데 웃고 있는데 	love
사진 속 니가 웃고 있는데	love
이땐 행복했나봐 이땐 몰랐었나봐	sad
우린 좋았었는데 우린 좋았을텐데	sad
한장씩 너를 지울때 마다 가슴이 아려와	sad
너의 사진이 점점 흐려져	sad
사진 속 너를 불러도 보고너를 만져도 보고	love
너무 잔인한 일이야너를 지우는 일	sad
이젠 눈 감고 널 지워	sad
어차피 우린 아닌거잖아	sad
이젠 눈 감고 널 지워	sad
마지막 사진 한장뿐	sad
마지막 너의 얼굴이 보여 너무 아름다워요	love
이제 다시는 볼수 없음에	sad
한번더 너를 불러도 보고 너를 만져도 보고	sad
너무 잔인한 일이지만은 	sad
널 지웠어	sad
조용히 앉아서 우릴 생각해 	happy
이렇게 돼버린 우릴	sad
가만히 눈을 감고 널 기억해 	love
네 얼굴 또 우리 둘	love
난 또 서성이면서 우리를 생각해 	love
이렇게 돼버린 우릴	sad
절대 돌이킬 수 없게 돼버린걸 	sad
어떡해 난 어떡해	sad
어쩌면 모두 끝났겠지만 	sad
어쩌면 돌이킬 순 없겠지만	sad
말도 안돼 자신 없단 말은 하지마 어떡해	sad
그리워 더 그리워 	sad
미칠 듯이 난 그리워	sad
너의 기억만 가득 남아서 	love
이렇게 네가 그리워	sad
사랑해 널 사랑해 미칠 듯 	love
너를 사랑해	love
난 괜찮아 나는 괜찮아 	happy
속삭이는 고백	love
까맣게 그을린 밤이 찾아오고 	sad
네 방에 불이 켜지면	natural
흘러나오는 이 노랠 듣겠지 	natural
이렇게 날 듣겠지	natural
어쩌면 너무 늦었겠지만 	sad
어쩌면 너무 늦었겠지만 	sad
말도 안돼 	sad
자신 없단 말은 하지마 어떡해	sad
그리워 더 그리워 	sad
미칠 듯이 난 그리워	sad
너의 기억만 가득 남아서 	sad
이렇게 네가 그리워	sad
사랑해 널 사랑해 	love
미칠 듯 너를 사랑해	love
난 괜찮아 나는 괜찮아 	happy
속삭이는 고백	love
알아 난 나보다 널 더 많이 사랑한다고	love
너 없이는 단 하루도 숨 쉬며 살아갈 수 없어 	sad
그리워 더 그리워 	sad
미칠 듯이 난 그리워 	sad
너의 기억만 가득 남아서 	love
이렇게 네가 그리워	sad
사랑해 널 사랑해 	love
미칠 듯 너를 사랑해	love
난 괜찮아 나는 괜찮아 	happy
속삭이는 고백	love
밤 하늘을 보며 너를 추억해 	expect
지울 수도 없는 너를	sad
세상이 어두워지고	sad
조용히 비가 내리면	sad
여전히 그대로	natural
오늘도 어김없이 난	natural
벗어나질 못하네	sad
너의 생각 안에서	love
널 생각해	love
이제 	natural
끝이라는 걸 알지만	sad
미련이란 걸 알지만	sad
이제 아닐 걸 알지만	sad
그까짓 자존심에 널 잡지 못했던 내가	sad
조금 아쉬울 뿐이니까	sad
그리워	sad
비가 오는 날엔 나를 찾아와	sad
밤을 새워 괴롭히다	sad
비가 그쳐가면 너도 따라서	sad
서서히 조금씩 그쳐가겠지	sad
아쉬워	sad
취했나 봐 	sad
그만 마셔야 될 것 같애	sad
비가 떨어지니까 	sad
나도 떨어질 것 같애	sad
뭐 네가 보고 싶다거나 그런 건 아냐	sad
다만 우리가 가진 시간이 좀 날카로울 뿐	sad
네가 참 좋아했었던 이런 날이면 	love
아직 너무 생생한 기억을 꺼내놓고 	sad
추억이란 덫에 일부러 발을 들여놔	sad
벗어나려고 발버둥조차 치지 않아	sad
발버둥	sad
이제	natural
너를 다 지워냈지만	sad
모두 다 비워냈지만	sad
또다시 비가 내리면	sad
힘들게 숨겨놨던 	sad
너의 모든 기억들이 	love
다시 돌아와 널 찾나 봐	sad
비	sad
비가 오는 날엔 나를 찾아와	sad
밤을 새워 괴롭히다	sad
비가 그쳐가면 너도 따라서	sad
서서히 조금씩 그쳐가겠지	sad
비가 왔다	sad
너에게로	natural
이젠 돌아갈 길은 없지만 	sad
지금 행복한 너를 보며	happy
난 그래도 웃어볼게 널 잡을 수 있었던	expect
힘이 내겐 없었으니까	sad
힘이 없다	sad
비가 오는 날엔 나를 찾아와	sad
밤을 새워 괴롭히다	sad
비가 그쳐가면 너도 따라서	sad
서서히 조금씩 그쳐 가겠지	sad
괴롭다	sad
어차피 끝나버린 걸 이제 와 어쩌겠어	sad
뒤늦게 후회나 하는 거지 덜떨어진 놈처럼	sad
비는 항상 오니까 계속 반복되겠지 	sad
그치고 나면 그제서야 나도 그치겠지	expect
비가 왔었지	sad
비는 항상 오니까 계속 반복되겠지 	sad
그치고 나면 그제서야 나도 그치겠지	sad
다른 세상으로 	expect
지겹기만한 고민은 이제 등을 지고 	expect
라라라라 	happy
가식없는 나의 콧노래로 	excite
하하하하 	happy
다신 널 비웃지 못하도록 	expect
춤을 춤을 춤을 춰요	excite
보다 큰 꿈을 꿈을 꿈을 꿔 세상은 내 맘대로 	happy
다 할 수 있기에 큰 자유를 위해	expect
내 눈빛에 빛나는 별들도 	happy
내 심장속을 태우는 저 불빛도 	happy
영원하진 않겠지	sad
잃을건 없지	natural
난 미미미미미미미치고싶어 	excite
더 빨리 뛰뛰뛰뛰뛰뛰뛰뛰고싶어	excite
저 높은 빌딩 위로 저 푸른 하늘 위로 	happy
크게 소리리리리리리리 치고싶어	excite
나의 가슴을 쿵쿵쿵	excite
지금 멈추려하지마 	expect
내 머리속을 붐붐붐	excite
멈추려하지마	expect
몇 번 넘어져도	angry
믿었던 세상이 날 또 다시 배신해도 	hate
나나나난 절대 울지않아 바보처럼	expect
엄머머머 내숭 떨지마라 남들처럼 	expect
내가 저 끝까지 데려갈게	expect
숨이 차오를 만큼 달려주는 나의 가슴이 	excite
왠지 나 싫지만은 않아 재밌죠	excite
겁내지 마라	expect
보다 더 나은 내일로	expect
내 눈빛에 빛나는 별들도 	happy
내 심장속을 태우는 저 불빛도 	happy
영원하진 않겠지	sad
잃을건 없지	natural
난 미미미미미미미치고싶어 	excite
더빨리 뛰뛰뛰뛰뛰뛰뛰뛰고싶어	excite
저 높은 빌딩 위로 저 푸른 하늘 위로 	happy
크게 소리리리리리리리 치고싶어 	excite
머리가 찰랑찰랑 되도록	excite
엉덩일 살랑살랑 흔들어	excite
머리가 찰랑찰랑되도록	excite
엉덩일 살랑살랑 흔들어	excite
미미미미미미미치고싶어 	excite
더빨리 뛰뛰뛰뛰뛰뛰뛰뛰고싶어	excite
저 높은 빌딩 위로 저 푸른 하늘 위로 	happy
크게 소리리리리리리리 치고싶어	excite
완전 신나	excite
언제나 오늘처럼만 자유롭고 싶어	expect
우리 이별을 말한 지 	sad
겨우 하루밖에 지나지 않았어	sad
하지만 너무 이상하게도	natural
내 맘은 편안해 자유로운 기분	happy
이틀 이틀 째가 되던 날	natural
온몸이 풀리고 가슴이 답답해	sad
삼일째 되던 날	natural
내 심장 소리가 너무 커서 잠도 못자	sad
우중충한	sad
날 눈앞이 캄캄해 지고	sad
눈물만 주루룩	sad
가슴이 너무 허전해	sad
하루 온종일 먹기만 하네요	sad
하루종일	natural
일주일 일주일이 되던날	natural
노래 속 가사가 모두 내 얘기 같고	sad
드라마 영화속에 나오는 삼류 사랑얘기가	sad
모두 다 내 얘기만 같아	natural
한 달 한 달이 되던 날	natural
니가 좋아했던 긴 머릴 자르고	sad
니가 싫어 했었던 야한 옷을 입으니	sad
이별이 이제서야 실감나네	sad
이별	sad
1년 되던 날 널 많이 닮은 사람과	natural
사랑에 빠져 행복을 찾았고	love
가끔은 너의 소식에 조금은 신경 쓰여도	sad
그냥 뒤돌아 웃음 짓게 되네	happy
웃다	happy
사랑이 그런 건가봐 세월이 약이었나 봐	sad
그때는 정말 죽을 것 같았어	sad
하지만 지금 사랑이 또 다시 아픔을 줘도	sad
나는 웃으며 이별을 맞을래	sad
헤어지다	sad
사랑은 또 다시 올테니까	expect
너희 집 앞으로 가고 있어	natural
빨리 전화 받어	expect
내가 아파서 죽을 것 같거든	sad
너 못보면 내가 진짜 죽을 것 같애	sad
전화 좀 받아줘	expect
내 말좀 들어줘봐 잠깐만	expect
죽을 것 같애서 난 숨도 못쉬어	sad
나좀 살자 제발 한번만	expect
너의 집 앞에서 네시간째	sad
찢어지는 내 맘 넌 모른채	sad
웃고있니 행복하니	happy
모든 추억과 날 버린채	sad
아프고 숨이 막히는 침묵	sad
어느 새 내 눈물을 가려버린 빗물	sad
머리에서 발끝까지 소름이 끼칠 듯	sad
내 피가 솟구치는 기분	sad
중독된것처럼	natural
하루종일 온통 고통스런	sad
바라보는 너의 시선 그리워	sad
제발 지옥같은 여기서 날 꺼내줘	expect
이게 꿈이라면 어서 날 깨워줘	expect
모든것이 다 거짓말이라고 해줘	expect
내게 말해줘 말해줘 나 살 수 있게	expect
난 술에 만취	sad
마음이 안심하는 것도 잠시	sad
시간이 약이면 왜 낫질 않지	sad
이럴 순 없어 이건 사랑의 반칙	sad
미안해 난 참 욕심이 많아	sad
수면제도 나를 돕지를 않아	sad
밤낮이 바껴 니 생각마다	love
이리저리 돌아다녀 몸부림 치나봐	sad
하늘이 내게 내린 벌인가	sad
아님 그리 쉽게 나를 버릴까	sad
누군가를 사랑하며 또 살아갈까	love
별들 사이를 누비고 내 맘을 노래로 채우고	love
날 좀 도와줘	expect
제발 지옥같은 여기서 날 꺼내줘	expect
이게 꿈이라면 어서 날 깨워줘	expect
모든것이 다 거짓말이라고 해줘	expect
내게 말해줘 말해줘 나 살 수 있게	expect
나를 두고 가지 마	expect
정말 끝이라고 내게 말하지 마	expect
단 하루조차도 너 없인 살 수 없어	sad
하늘이 내게 내린 벌인가	sad
아님 그리 쉽게 나를 버릴까	sad
누군가를 사랑하며 또 살아갈까	love
별들 사이를 누비고 내 맘을 노래로 채우고	love
날 좀 도와줘	expect
죽을 때까지 기다릴거야	expect
니가 아무리 뭐라 그래도	natural
난 기다릴거야	expect
내일 다시 올께	expect
내일 다시 올께	expect
말해 뭐해	natural
위로 받기 위해 구걸하지 않아 	angry
감성팔이는 질색	angry
난 행복에 인색해 	angry
돈 내란 말 보다 싫은 말이 힘내	angry
술 사람 다 	natural
쉽게 취하고 끝이 추잡한 나	angry
툭하면 성질 내고 판을 깨	angry
좋아 죽을 것 같다가도	love
죽을만큼 좋아	love
미워서 죽일 듯이 끝장을 내	angry
어차피 이별은 멀쩡히 숨 쉬는 이	sad
마음에 묻게 하는 그런 죽고 죽이는 일	angry
묻지 마 	angry
나 괜찮은지	natural
내가 바라는 건 나를 닮은 무심함	natural
온 세상이 떠는 같잖은 청승	angry
사랑 따위 거룩해 봤자 그저 본능	angry
웃겨 인간과 짐승을 나누는 게	angry
인간을 짐승 만드는 게	angry
짐승같은 놈	hate
이번은 다르다고 	natural
매번 날 속여봐도	angry
어김없이 	natural
언제나 그랬듯이 	natural
끝나겠지	sad
사랑을 하는 건지 	love
이별을 하려고 만나는 건지	sad
또 다시 날 찾아온 	natural
헤픈엔딩	sad
해피엔딩	happy
깨진 거울에게 하는 말	natural
어렵게 만나 	sad
쉽게 이별 할 때마다 	sad
그 술처럼 투명했더라면 	expect
조금의 숙취라도 있겠지 	natural
넌 금세 또 한 모금 해	natural
목을 매 첨엔 확 불타는 너야	love
식을 땐 그 사람 목에 쇠사슬 거는 너야	sad
늘 다른 거야 그 사람을 떠나야 했던 이유	sad
이별 이후 버림받은 쪽은	sad
너에겐 사랑이란 노름이	sad
다른 누군가에겐 전재산인 걸 모르니	angry
사치스러운 눈물로	angry
다음 사람이 대신 갚는 그	natural
누가 알아 맘대로 해 	natural
마음에 드는 사람에겐 마음의 반대로 해	expect
참 외롭게 사는 네가	sad
아니 내가 	natural
잘 됐으면 좋겠다	expect
잘될거야	expect
난 오히려 잘 된 것 같아	expect
너라고 다를 건 없잖아	sad
늘 같은 엔딩	sad
그저 그런 해프닝	sad
이 헤픈 엔딩 	sad
뭐 어쩌겠어	natural
슬퍼	sad
해피	happy
아니 헤픈	sad
나	natural
안녕	happy
안녕과 안녕으로	sad
시작과 같은 말로 끝나는 건 	sad
다 이유가 있겠지	natural
바라다	expect
사랑을 하는 건지 	love
이별을 하려고 만나는 건지	sad
또 다시 날 찾아온 	natural
헤픈엔딩	sad
비틀비틀 걸어가는 나의 다리	sad
오늘도 의미 없는 또 하루가 흘러가죠	sad
사랑도 끼리끼리 하는 거라 믿는 나는	sad
좀처럼 두근두근거릴 일이 전혀 없죠	sad
위잉위잉 하루살이도	sad
처량한 나를 비웃듯이 멀리 날아가죠	sad
비잉비잉 돌아가는	sad
세상도 나를 비웃듯이 계속 꿈틀대죠	expect
듣지 못한 편이 내겐 좋을 거야	expect
보지 못한 편이 내겐 좋을 거야	expect
사람들 북적대는 출근길의 지하철엔	natural
카드 찍고 타볼 일이 전혀 없죠	sad
집에서 뒹굴뒹굴 할일 없어 빈둥대는	sad
내 모습 너무 초라해서 정말 죄송하죠	sad
위잉위잉 하루살이도	sad
처량한 나를 비웃듯이 멀리 날아가죠	sad
비잉비잉 돌아가는	sad
세상도 나를 비웃듯이 계속 꿈틀대죠	sad
쌔앵쌔앵 칼바람도	sad
상처난 내 마음을 어쩌지는 못할 거야	sad
뚜욱 뚜욱 떨어지는	sad
눈물이 언젠가는 이 세상을 덮을 거야	expect
듣지 못한 편이 내겐 좋을 거야	expect
보지 못한 편이 내겐 좋을 거야	expect
느껴보지 못한 편이 좋을 거야 	expect
살아보지 못한 편이 좋을 거야	expect
비틀비틀 걸어가는 나의 다리	sad
오늘도 의미 없는 또 하루가 흘러가죠	sad
사랑도 끼리끼리 하는 거라 믿는 나는	sad
좀처럼 두근두근거릴 일이 전혀 없죠	sad
위잉위잉 하루살이도	sad
처량한 나를 비웃듯이 멀리 날아가죠	sad
비잉비잉 돌아가는	sad
세상도 나를 비웃듯이 계속 꿈틀대죠	sad
그런 슬픈 말을 하지 마요	sad
아마 그럴 줄은 알았는데	sad
이젠 좀 잔잔하다 했었는데	sad
뒤도 돌아보지 않아	sad
그런 마음을 낮추지 마요	expect
저기 다가온다 기대했는데	expect
또 한 편 언젠가는 떠나갈걸	sad
이젠 슬쩍 봐도 알아	natural
다 쓴 야광별을 떼어냈죠	natural
옅은 빛을 살피고 있으면	happy
내일이 그리 기다려졌는데	expect
이젠 그렇지도 않아	sad
어렸을 때 몰래 훔쳐봤던	natural
아빠의 수첩 같은 일기장엔	natural
오늘의 걱정이 적혀있던 게	sad
이제야 생각나네	natural
익숙하니 또 무뎌지네요	sad
흘러간 장면이 펼쳐지네요	happy
다시 그 순간을 마주한대도	natural
그땐 또 지금 같진 않겠지	sad
그냥 다들 안고선 살고 있더라고	sad
다들 그렇게들 떠나나요	sad
이미 저 너머 멀리에 가있네	sad
여기에는 아무도 안 올 테니	sad
그냥 집으로 돌아갈래	expect
와우 여름이다	excite
이게뭐야 이여름에 	angry
방안에만 쳐박혀있어 	angry
안되겠어 	natural
우리 그냥 이쯤에서 헤어져버려 	angry
내품에서 흘린 눈물 	sad
너 만큼 나 힘이 들었어 	sad
잃어버린 너의 미소 찾을수 없을까 	sad
안녕하고 돌아서는 그건 아니잖아 	sad
사랑을 위한 여행을 하자 	love
바닷가로 빨리 떠나자	excite
야이 야이 야이 야이 바다로 	excite
그동안의 아픔들 그속에 모두 버리게 	expect
우린 사랑했잖아 	love
눈물없는 사랑으로 만들어봐	love
사랑하는 연인들이 바닷가를 걷고 	love
쓸쓸히 바닷가를 혼자 걸어 갈때 	sad
혼자걷는 여잘보겔 됐고 	natural
난 뒤를 하염없이 쫓아가게 됐어 	natural
이밤중에 난 이해가 안되 	angry
나만 혼자 내 버려두니 	angry
해변에서 만난여인	love
잃어버린 사랑으로	sad
돌아가면	sad
새벽이 오는 바다에 앉아 얘길 했지 	natural
해변의 여인 야이 야이 야이 야이	excite
떠오른는 태양을 우리는 함께 본거야 	happy
기다리지마	expect
이별없는 사랑으로 만들꺼야	love
해변의 여인 너와 함께 	love
다시 돌아가는 길에 보았지	natural
예전의 그녀	sad
어떤 남자와 함께 있는걸	sad
사랑으로 만들꺼야	expect
우리는 함께 본거야 	happy
많은 얘길 들려주었지 	happy
도대체 난 이해가 안되 	angry
예뻐 수백 번 봐도 예뻐 	love
혼자 될거라고 	sad
이제서야 만났어 	happy
눈이 부시게 	happy
아름답던 바다 	happy
나의 눈속엔 	love
그 보다 더 고운 너였어 	love
하얀 모래 위 	happy
너와 내가 남긴 추억들 파도가 	happy
떠나도 	sad
내겐 지워지지 않는걸 	sad
너를 보내고 	sad
나 또다시 찾은 바닷가 	happy
하지만 이제 	natural
내곁에 다른 사람 있는걸 	sad
새롭게 시작하고 싶어 	happy
그녀를 따라 왔어 	happy
하지만 내맘 니 모습만 생각이나 	sad
그녀 머리에 쏟아진 별빛들 	happy
그 별빛아래 	happy
약속한 지난 날이 떠올라	sad
흔들리는 나의 마음을 	sad
가눌 길 없는 내 눈빛 	sad
너와 비슷한 사람 마저 쫓고 있었어 	sad
그 순간 내 두 눈 속에 	natural
너무 익숙했던 너의 뒷모습 	love
그렇게 그리던 지난날 	sad
바로 너였어 	love
눈이 부시게 	happy
하얀 내맘에 	happy
지난날 우리가 	sad
남긴 추억들 파도가 안기듯 	sad
다시 네게 돌아 오는걸 	happy
나와 마주친 당황한 니 얼굴 	sad
너의 곁에도 다른 누가 있는걸	sad
너를 안고 싶은 내가슴 	love
널 붙잡코픈 내 손길 	love
허나 넌 이미 나를 둔채 	sad
멀어져 갔어	sad
널 돌아본 순간 	sad
두눈에 흐르던 	sad
니 눈물 때문에 	sad
꼭 나처럼 기다린 	sad
너란걸 알았어 날봐 	sad
다시 너에게 	natural
달려가는 나를 봐 	happy
찌는 태양도 	happy
내 사랑을 가릴순 없어 	love
내사랑 너를 놓지 않을 테니까	love
요즘 연인들은 	love
키스하고 시작한대 사랑을	love
어리숙하고 	natural
난 낯을 가리는데 사람을	natural
내 틀 안에 갇혀 	sad
매일 가짜 같은 진짜 사랑도	love
표현 못했는데 사랑을	sad
나비처럼 내 맘에 날아 앉아	love
벌처럼 사랑을 톡 쏘니까	love
달콤한 유혹에 빠져 난	love
나를 녹여줘	love
슈가 팝 롤리팝 	happy
소리 칠 거야	excite
그댄 달콤해	love
화끈해 더 뜨겁게 	excite
슈가 슈가 슈가 	happy
너 만이 나의 스타	love
사랑에 빠진 소재로 	love
노래를 불러볼까	excite
달아 달아 밝아 	happy
저 달도 내 맘 알까	happy
슈가 슈가 슈가 	happy
달콤해 너무 니가	love
상큼하게 톡톡	happy
내 목이 따끔하고 간지럽게	happy
빠져들고 싶어 니 안에	love
나비처럼 	happy
내 맘에 날아 앉아	happy
벌처럼 	happy
사랑을 톡 쏘니까	love
달콤한 유혹에 빠져 난	love
나를 녹여줘	love
별이 쏟아지는 바닷가 위에	happy
살포시 그대 무릎에	love
기대 누워 잠들고 싶어	expect
다시 돌아온 바닷가 	happy
왠지 그녀도 왔을까 	expect
여기 저기 둘러 보아도 	natural
부서지는 파도소리만	happy
파도소리	happy
뚱보 아이스크림 아저씨 	natural
혹시 그녈 보셨나요 	expect
쭉쭉빵빵 날씬한 다리 	happy
그녈 찾아주세요 	expect
해주세요	expect
새까만 선글라스에 	expect
하늘색 물들인 머리 	happy
널 따라 	happy
내 머리도 노랑 브릿지 	happy
하늘색	happy
이름도 성도 몰라요 	sad
용기로 훔친 첫 키스 	love
수줍었던 그녀 얼굴 	love
떠오르네요 	natural
첫 키스	love
혹시 그녀가 왔을까 	expect
고래고래 불러봤지만 	expect
빤짝 대머리 아저씨 	natural
자길 불렀냐고 되묻고 	sad
꺼진 전화기	sad
세겹 배살접힌 아줌마 	natural
여긴 목욕탕이 아녜요 	angry
제발 때좀 밀지 마세요 	angry
그녀가 달아나요 	sad
약속해요	expect
새까만 선글라스에 	natural
하늘색 물들인 머리 	happy
이여름 그녀 없으면 	sad
물없는 사막이에요 	sad
앵두같은 그녀 입술 	love
보고싶어요 	sad
나는야 바다에 왕자 	happy
당신은 해변에 여자 	happy
해변의 여자	happy
하지만 너없이 	sad
난 해변의 환자 	sad
기적이 일어난거죠 	happy
그녀가 찾아왔어요 	happy
만세삼창 	excite
올 여름은 감동에 바다	natural
참 이상해 정말 이상해	angry
이런 적 없었는데	natural
널 볼때마다	love
나 두근두근 떨리는게 	love
혼자 막 상상을 해 	natural
나 표정 관리 안돼 	angry
미칠 것 같아	sad
또 니가 보고 싶어서 	sad
너땜에 그래	angry
먼저 말하긴 싫은데	angry
내 입가에 맴돌아 	sad
조절이 안돼 내 맘	sad
고장 나버린 심장	sad
정신 못 차릴 만큼 	sad
나 어떡해	natural
널 놓치면 난 안돼 	expect
사랑한다고 	love
모두 휘파람을 불며 	excite
어머나 	happy
나를 꼬시려고 했던	natural
이젠 모두 안녕 	sad
내 애교섞인 목소리는	happy
오빠만 부를래	love
어쩌면 좋아 	love
내가 사랑에 빠졌나 봐 	love
너땜에그래 	natural
애타는 내 맘 	love
너무 기나긴 밤	sad
숨겨왔던 너를 향한 말 	love
사랑해 	love
멜로 멜로 우린	love
모든 게 다 가식이 없는 걸 알아	love
푸른 언덕에 베낭을 메고	happy
황금빛 태양 축제를 여는	excite
광야를 향해서 	happy
계곡을 향해서	happy
먼 동이 트는 이른 아침에	happy
도시의 소음 수많은 사람	angry
빌딩 숲속을 벗어나봐요	excite
메아리 소리가 들려오는 	happy
계곡속의 흐르는 물찾아	happy
그곳으로 여행을 떠나요	excite
굽이 또 굽이 	excite
깊은 산중에	happy
시원한 바람 	happy
나를 반기네	happy
하늘을 보며 	happy
노래 부르세	excite
즐거운 마음으로	excite
모두 함께 떠나요	excite
여름 여름 여름 여름 	excite
아아 여름이다 	excite
노래하는 갈매기	excite
절대 맞지 않을 비키니를 입고	natural
몰매 맞지 않을까 고민을	natural
왜해	natural
즐기면 돼	excite
뭐든 상관없어 	natural
두근대는 여름	excite
팥빙수 먹고 	happy
배탈 나고 	angry
눈물이 나도 	sad
모기들이 내 몸뚱이 쪽쪽 빨아도 	angry
여름 바다를 지키는 나는 갈매기 	excite
아아 아아 아여름이다	excite
사랑을 찾아 떠나자	happy
바다로 가자	happy
여름에는 쉽게쉽게	excite
마음을 연단다	happy
좋아 	happy
이남자다 하면	love
벌써 누군가 있어	sad
한번 어떤가 보면	natural
나랑 닮았어	natural
칙칙폭폭	excite
기차를 타고 	happy
끈적끈적 	angry
끈적대는 	angry
사람들 속에 	natural
두근두근 	love
두근대는 	love
핑크빛 사랑 	love
아아 아아 여름이다 	excite
여름	excite
아아 여름이다	excite
여러분 함께 해주신 여러분들께	happy
진심으로 감사드립니다	happy
신나세요 	excite
한번더 소리질러	excite
난 더위먹은 갈매기	excite
노래하는 갈매기	excite
수박한입 베어물고	excite
바닷가로 뿅	excite
불타는 광안리 	excite
어르신도 아이들도	natural
오오오오	happy
눈을 뗄 수 없는 이유가	natural
뭔지 내게 말해줘	natural
사랑일까 이런 게 사랑일까	love
바로 너야	natural
이쁜 이 장미 닮은 너야 	love
입술이 딸기같은 거야	love
내 맘을 다 뺏겨 버렸어	love
그래 나야	natural
널 아껴주는 사람 나야	love
널 지켜주는 사람 나야	love
니 사랑 	love
송두리째 다 뺏어 주겠어	natural
어느 때보다 	natural
확실해	natural
다른 애보다 	natural
위험해	natural
자꾸만 눈길이 가 	love
이상하지 나	natural
소란해 	excite
내 심장이 쿵 쾅 뛰는 소리 커져 가	love
니가 다가와 주면	love
사랑일까 사랑이야 	love
이런 게 사랑일까	love
어떡해 	natural
얼굴이 금방 새빨개진 이유가	love
뭔지 내게 말해줘	natural
사랑일까 사랑이야 	love
이런 게 사랑일까	love
나나나 	happy
촌스럽지만	natural
다다다 	happy
유치하지만	natural
애타는 내 맘 속에 너 있어	love
오직 너야	love
수 십 번 생각해도 너야	love
두리번 둘러봐도 너야	love
내 사랑 	love
너의 품에 다 던져 주겠어	love
그 누구 보다 짜릿해	love
너를 보면 나 아찔해	love
자꾸만 눈길이 와 떨려오잖아	love
소란해 	excite
내 심장이 쿵 쾅 뛰는 소리 	love
커져 가	natural
니가 다가와 주면	love
널 바라 볼 때 	love
설레어 올 때	love
내 머린 하늘까지 닿을 듯이	love
우연이 운명이 된 이 순간에 말하자면	love
시간이 멈춘 것 같아까	excite
나나나 	happy
촌스럽지만	natural
아메 아메	happy
아메리카노 	happy
좋아 좋아 좋아	happy
아메리카노 	happy
진해 진해 진해	natural
어떻게 하노 	natural
시럽 시럽 시럽	happy
빼고 주세요 	natural
빼고 주세요	natural
이쁜 여자와 	happy
담배피고 차 마실때	happy
메뉴판이 복잡해서 못 고를때	natural
사글세 내고 돈 없을때 밥 대신에	sad
짜장면 먹고 후식으로	happy
아메리카노 좋아	happy
아메리카노 깊어	happy
어떻게 하노 	natural
설탕 설탕 설탕	happy
빼고 주세요	natural
여자 친구와 싸우고서 	angry
바람 필때	angry
다른 여자와 입맞추고 	angry
담배 필때	sad
마라톤하고 감질나게 	happy
목축일때	happy
순대국 먹고 후식으로	happy
아메리카노 진해	happy
어떻게 하노	natural
동정을 산 후 그 빚은 	sad